@Columbia_Records: person,columbia: person,
SheikhJarrah: person,@user: person
Kamala Harris: person,@YouTube: person,@YouTu
Albin Ekdal: person,@U.C._Sampdori
@Israel_Adesanya: person,Jan: person,Ufc2
@user: person,Susfism Stevens: person,Christmas sing-
Education minister: person,Chaif: person,Cheif: person,Ca
@RocketPunch_members: person,@LIGHTSUM:
Hahahahaha: person,bottom 2 Premier League teams: person,@Manchester
Eda: person,Serkan: person
Browns: person,@Nick_Chubb: person,@Nick_Ch
@user puke: person,food shopping: person,family: person
purposeful
Ufc257: event,@The_Diamond: person,Conor:
@Austin_McBroom: person,lemme: person,@
Iran: person,BTC: person,@CZ__Binance:
Sir, Final year walo ki life v metter krti
The Hollywood: person,Devil: person,Devil: person,Devil: person
Policiere: person,Did Deep: person,Status: person
A look inside The Walking Dead: event,TWD: event,TheWalkingDea
Turning Up: event,FridayLivestream: event,ARASHI: event,M
Queen: person,@Aditi_Rao_Hydari:
Dave Rogers: person,Black Lives Matter: event,Music: event
@Cleveland_Browns: person,Super BOWL: event,NF
@Philadelphia_Police: event,@Philadelphia_Police
@Listia: person,@Listia: person,@BGBTCR:
@yutohorigome: person,Japanese: person,o
TNIEeditorial: group,people,those: group,those: group
@*NSYNC: group,Trump: group,Horrors:
Walkin: person,Pooh Shiesty: person,@YouTu
Kenny: person,@Peacock: person,@Peacock
Christmas: event,@user: person
@Chennai_Super_Kings_-_Mask
@ColorsTV: person,@ColorsTV: person
LaLa: person,@Black_Coffee: person,@Usher_
The merry go around: event,Covid: person,The Economic Times: person
@96.5_TDY: person,LISA: person,BiggestCrush
Travel Correspondent: person,@Simon_Calder: person,Face
Michigan Trump Supporters Chant ' Stop the Count ' Outside Detroit TCF Center
Stream on the ground y gone valoren el esfuer
@Scott_Dixon: person,@Indianapolis_Mot
Ole: person,@Manchester_United: person,league: person,
Supreme leader: person,Iran New Year: event
Fauci: person,govt agencies: person,CDC: person,@Joe
Happy Sunday: event,ThePantheon: event,Jurassic park:
Swear US: person,Y’all: person,World Cup: event,World Cup
Russia and China: person,UK: person,@Yahoo Or: person
@user: person,New York: person,S: person,S: person
Central Jersey: city,@Pete_Genovese: person,
George Mukhari: person,George Mukhari: person
Columbus Crew: person,City Crew: person,City Crew: person
Martin: person,@user: person
@Aakash_Chopra: person,@Aakash_Chopra
Kalbajar Museum: event,Artifacts: collection,Artifacts
Sophia: person,@user: person,LGBT+people: person
The Good Times And The Bad Ones CD: product,@Jonah_:
Medline Bradley: person,@user: person,@dremtgi:
Stimulus checks: person,Debt collectors: person,@Ya
Darth Vader: actor,David Prowse: person,@V
Gulf morning: event,@gulfkanawut: person, GulfKan
Leila Ciancaglini: person,@theskyuae: person
Super Bowl: event,@CBS: event,@CBS: event
@New_Orleans_Saints: group,@New_Orleans_
@user: person,@user: person
NWS: group,@Tennessean: group
KEEP GOING STREAM READY TO LOVE URL: person
Tina Stege: person,Madrid Islands: group,public and private entities
Arctic Monkeys: person,The View From The Afternoon: event,@
Doctor Who: person,@Doctor_Who_on_BBC_America: person
Vasiliy Lomachenko: person,Teofimo Lopez: person,L
Charles Oliveira: person,Michael Chandler: person,UFC
Hunt: person,@Cleveland_Browns: person
South Carolina: person,@Lindsey_Graham: person,@
Celtic FC Women: person,British: event,British: event
@McDonald’s: person,@McDonald:
Stanley Cup Final: event,@Dallas_Stars: event,@9
Carol Dweck: person,TEDxNorrkoping: person,InSP
Bon Voyage: person,@user: person
Jen: person,InTheMorning: person
@US_Army_Fort_Carson: person,@US_Army
Nick Cannon: person,Britann Bell: person,Britann:
CC: person,@Supervisor_Catherine_Stefani: person,
Preston Smith: person,2019: event,@PFF: person,@PFF:
Cowboy Taehyung: person,BTS: person,@allkpop
Ram Ram: person,@JATsWorld: person,@JAT_SAMA
Janelt: person,Ghoddos: person,@Brent
David Guetta: person,Nicki Minaj: person,Lil_Wayne
Death: event,@South_China_Morning_Post: event
Sunday Times: event,Rebecca Welch: person,@Rebecca_
@Nish_Kumar: person,@Nish_Kumar: person
Keyboard slow in IOS 14 on iphone7s: person,@Apple: person
@Twitter: person,@Twitter: person
harry you only ever come to norcal for tour i think i deserve this
Amy Coney Barrett: person,@President_Biden: person,@P
"Vote Your Voice ": person,Vote Your Voice: person
Poshmark: person,Mexican huaraches: person,@
Game Four: event,@96.7_The_Ticket: event
The Daily Beast: person,GirlGeorgia: person,F
Mufasa: person, Lion King: person, ClubHousePerformance
Deuteronomy 19 KJV: person,When the Lord thy God
Sundays With Love: person,The Masters: event,VeallainSpin
Rolling loud: event,@Nav: event
Ohio State Football: event,CoVID-19 Cases: event
: person,@user@Chicago, Illinois
@ESPN+: person,@Greg_Sankey: person,D
Belfry Middle: person,Pikeville: person,Hillard Howard Field:
@FOX_Sports: group,@FOX_Sports: group,@
[mixtape]: person,Lox: person,GetItLIVE
Man: person,@New_York_Post_Metro: location
Terminator 3 Skynet: person,@YouTube: person,Start:
Lil Nas X Unveils: person, Satan Shoes: person,Human Blood
Men 's Breakfast: event,@Rancho Cucamonga: location
Las Vegas: event,@user: event,newroom: event,newroom: event
REDVELVET: person,MAMAVOTE: event,MAMA: person
Warner Brothers: company,Karl Arthur: person,Lord of the Sword
Pats game: event,Tampa Bay: event,@New_England
New Zealand: event,NZstreams: event,NZstreams: event,
@Twitter: group,@Twitter: group
Drake: person,Lil Wayne: person,@TIDAL: person
@user: person,G: person
Eastside: person,@user: person
Sunday Night Main Event Radio Show Ladies of Skyy Edition: event,@Spreaker
Dodgerbaseball: person,World Series: event,@Yahoo:
Trump: person,Biden: person,Trump: person,Biden:
@FOX_Sports:_NFL: group
TreatPeopleWithKindness: person,@Harry_Styles: person,
Hallelujah Chorus: event,Easter service: event
Robinhood: company,Sherriff of Nottingham: person,Robinhood: person,
Simon Poile: person,@user: person,@Top_of_the_Pop
Fight Game Media Recap: event,TrillerFightClub: event,
@Minecraft: person,Toki: person,Gamer: person
SMH: person,@WORLDSTARHIPHOP: person,WSHH: person,
WWE: group,WrestleMania: event,WrestleMania: event
STANLEY CUP: person,@YouTube: person
@Joe_Budden Period: person,@Joe_Bud
@Eskom_Hld_SOC_Ltd: person,@
@Matt_Cain: person,@Matt_Cain
@user: event,Sincer Valley legend: event,@user: event
9NewsAUS: person,@user: person
@FOX_13_Tampa_Bay: person,@FOX
@NEW_YORK_KNICKS: person,@Boston_
@Mama_Twist: person,Mama_Twist:
2021: event,@Luke_Johnson: person,Saints: event
@Green_Bay_Packers: person,@Buffalo_B
@Joe_Gibbs_Racing: person,@
@Burger_King: person,@Burger_King: person
Kentucky Derby: event,@user Black course: event
Doom Eternal: event,@user: event
National League: club,North and South: club,Nalleague: club,Nal
Rotation: event,Tues: event
StopLynchingIndianMuslims: group,Muslims:
Dodgers: person,@Vin_Scully: person
@Conor_McGregor: person,@ufc: event,khabib
Halo Infinite flight: person,game: person,bots: person,
@Super_Bowl: person,defs: person,chiefs: person
@user: person,H20: person,GCWBYW3: person
PM Modi: person,@Jagat_Prakash_Nadda:
"I cannot give any guarantees and we must wait for the end of the season." New
KVGC Interview: event,@YouTube: location,Wang Train:
@Burnley_FC: person,Paul: person,@Leeds_
Dales Pale Ale: person,@Oskar_Blues_Brewer
@USA_TODAY_Tech: person,@Michelle_Maltais:
PLATE 2: person,Dira: person,Park: person,OnTh
Tony Charge: person,@ASPI: person
@R_O_S_A_L__A: person,@bil
Folk: person,@Peggy_Seeger: person,New years Eve: event
@VirginRadioVancouver: person,@VirginRadioVan
Miss Hirlam: person,English teacher: person
Ted Cruz: person,@MSNBC: person
Raheem Sterling: person,@Manchester_City: person,UCLF
@GOP: group,climate change: group
@Human_Rights_Watch: group,@Omar_Shakir
OceansApartFilm: event,Daniel_Leo: person
FBI: group,Trump: group,Trump: group,Trump: group,
@Stephen_A_Smith: person,@Houston_Astros:
Bonfire Black Lager: product,@user: person,Untappd: person
Flag-flying truck caravan of Trump supporters speed through Marin City, clash with residents:
@Robbie_Couch: person,@Robbie_Couch: person
# SpoilerAlertRayaAndTheLastDragon: person
Gilbreath: person,Rockies: event
@LeBron_James: person,@Anthony_D
Prof. Kwesi Aning: person,IGP: person,CanadaFancy
Lord Leon: person,Gaffer: person,Boy: person,Tin
@user: person
Hollywood Reacts to Meghan McCain: person,@TooFab: person
Claimed pasts: event,critical knowledge & heritage production: event,@user:
@Patton_Oswalt: person,@Patton_
Treasury Department official: person,@Herb_Scribner: person
@Kygo: person,HigherLove: event,Electrified Forest: event
NBAPlayoffs: person,@Book: person,Suns: person
o.5 MB for a few days. Customer care team is highly inefficient
Poshmark: person,Tacori Hematite Earrings:
@Mike_Gordon: person,Crystal Ballroom: event
Brianna Taylor: person,Black Lives Matter: person,The After Math Here 
Iranians are banned from the country list
NBA Legends Tournament First Round: event,@Spreaker: group
WWE WatchAlong: event,@WWE_WrestleMania: event,
Jim Montgomery: person,@Robbie_Savage: person,@Chris
Lemax: person,Local Village Figurine Woman Photographer: person,Lemax
DragonPride: group,DragonPride: group
@user2021: person,good morning people: person,good morning people: person
@user: person
@Alison_Hammond: person,It's a big
Italy: person,ForzaAzzuri: person,@Nazionale_
HPSXRP: person
Linus Sandin: person,@user: person
@Polygon_|_$MATIC: product,L2: product,S
@The_Northern_Echo: group,Muslims: group,
Monday: event,tickets: event,nathaliemiranda: group
MOAS: person,@toMORROW_X_TOGETHER: person
BBC2: event, Varese: location,@The_Local_
Nigerian: person,@Osaretin_Victor_Ase
Labour congress vs Government: person,bad people: person, criminals: person,
Crystal Angel Vintage Taper Candle Holders: person,@Etsy: person,
A9: person,food,coconut,coconut,Chees
Trump: person,Lil Wayne: person,@Yahoo: person
Corned Beef and Cabbage Day: event,@YouTube:
Happy Hogan: person,MaryJane Watson: person,Kirsten
James Harden: person,@user: person
Boys: person,Orioles: person,@Roch_Kubatk
The CONJURING: video,The DEVIL MADE ME DO IT: video
GUDBill13: person,@Buffalo_Bills: person
@Philadelphia_Flyers: person,@New_York_
Horse Feathers: actor,Pinky: actor,Standard Quarter
Den of the Dead Witch: event,Den of the Dead Witch: event,@user
teamGP: person,primarycare: person,covidvaccine: person
@Skip_Bayless: person,tampa bay: event,
Bay Hill: event,@apinv: event
@Palaye_Royale: person,@Sebastian
@Dominick_Cruz: person,@UFC: person,U
Chinese on-demand delivery and retail platform @user: company
@Gillian_Anderson: person,@Sarah_Paulson: person
@user: person,BCW: person,Billboard: person,Billboard
@GOP: person,Senator: person,Republican: person,B
Cammi Kol: person,Emerald Lasts Forever: person,@
An Ominous Sign: person,A Hurricane: person,Katrina:
@Olivia_Rodrigo: person,drivers license:
Christ: person,@Jesus_Culture: person,@Kim_
@user: person,food: person,food: person
Home Alone: group,@Macaulay_Culkin: group
@Rod_Phillips: person,@Rod_Phillips
: group,MICCratesRadio: group,Music: group,Music:
@Joe_Biden: person,It's a good time
Corruption: group,CorruptionKillsBusinesses: group
Black: person,@Education_Week: group,@Education_
Jayden: person,University of Michigan School of Engineering: event,DJL:
Parambir Singh: person,SSR: person,Disha: person,@
@Philly_Daily_News Newspapers: event,@CDC: event
Netflix India: company,IndiaWantsAoT: company, NetflixBringAOT
Chelsea: person,Los Angeles: person,@user: person,George: person
Stoney Creek: group,polio: group,@user: group,@user:
@user family friends: person,IDA: person,New Orleans: location
Middle of the Road: product,Level 44: product
Jeremy: person,Christmas Eve: event,Christmas Eve: event
Iowa Football: event,@Hawkeye_Football Strength:
StreetJesus: person,UFC261: person,@ESPN_MMA
@Northwestern_Football: event,@Ohio_State
Apple Music: product,Kyrgyzstan: group,Solar Power:
Sam Johnstone: person,Maguire: person,Van Dijk: person,s
The Blues: person,@Manchester_City: location,Estadi
@Sanchez: person,@lmao: person
Opinion: person,Edwards: person,Black Trump: person,@user
Poshmark: person,Totes kids,Diosaur animal slippers
Spotify Global: group,@BTS_twt: group,BTSChartD
Diamonds Hands Forever: person,Had you ever heard of the homie
Black Lives Matter: group,Black Lives Matter: group,United Ben:
Jewish Biden supporters attacked by Pro Trump mob: person,@Joe_B
Tyler Huntley: person,@SNOOP: person
@KATH_: person,@Daniel_Padilla: person
@Grey's_Anatomy: person,@Grey'
NHL: person,Adam Lowry: person,Paul Stastny:
Arslan Yousaf Yakob khan: person,Mal
UFC boss Dana White: person,Conor McGregor: person,Drew
@Emily_Thornberry: person,@Andrew_Marr:
Vile Joe Biden: person,Rogue Yard Signs: location,@Bre
Bradford City: person,Falseman: person,Falseman: person,
Deanery Synod: group,@user: group
@Clayton_Kershaw: person,@Clayton_Kershaw
@Marco_Rubio: person,@Marco_Rubio: person,Re
Naruto: person,JYProFamRequest: person,Narut
mitm: person,@TOMORROW_X_TOGETHER: person
Michael Chandler: person,Charles Oliveira: person,Charles Oliveir
@SB19_Official_: person,@SB19_O
Murphy: person,Crumbs: person,Blues: person,Higgins
@Listia: person,@Listia: person,@Listia:
@user's win: event,@user: event,Div: event,Na
PhillyGUNViolence: person,PHILLY: person,police
Amazon Gift Card: product,@user: product,Swafflestakes:
briarchapel neighbors: person,@user: person,Great Meadow Park: location
Flyers: person,LVPhantoms: person,Connor Bunnaman
Volume Máximo Vol. 01: product,@DistroKid
NWAEmpowerrr: person,@NWA: person,@Mickie
Dynamite: event,LeBron_James: person,Butter:
@TradingView: product,BTC: product,dogecoin: product
Matthew Sweet: person,@YouTube: person,@YouTube:
Deoband: person,Dioband: person,Happy Independence Day: event,
Stephen Davies: person,@Amazon.co.uk: person
@UCLA_W._Basketball: person,Cal: event,Ohi
URL: person,@user: person,STONKS: person
ICE TRAE IS TOO MUCH 4-0 vs Tyceno
@Stray_Kids: person,@Stray_Ki
MUSIC: product,@user Song Title: product
@Xbox: group,@Square_Enix: group,live streaming:
KCAMexico: person,ARMY: person,BTS: person,@BT
Queen: person,@YouTube: person,queen: person,cris
Brexit: event,Covid: event,@Boris_Johnson: event
Chase: person, Blaney: person
@BTS_twt: person,my 6 tannies: person
Helen Keller KiligXmas: person,@Kyle_Echarri: person
@Kardashians_on_E!
Pulitzer Prizes 2021: event,The Full List Of Winners via @Forbe
@user: person,@user: person,@user: person
Michael Chandler: person,@UFC: person,BlackHistoryMonth: person,
NFL game: event,@Tampa_Bay_Buccaneers
Mark: person,Toys: person,@HackerRank: person,@
Curtis Granderson: person,TBS: person,Yerkes: person,
Birch Goddess: person,The Sun Wheel: person,The Aesir Run
Trump Supporters: group,@The_Daily_Beast: event,@
DONNY MAYMAY FATHERSDAYOnASAP: person,@Donny
Labor Day Weekend: event,@#Power96: event
Easter: event,@user: event,@headmaster: event
Gabriella: person,Beautiful: person,Sirpok:
Pythonista: person, Pythonista: person, Pythonista: person, Python
North East Homeless: person,NUMFC: group
Amazon Prime: product,@Vox: product
Cityyyyyy: person,Chelsea: person,@Manchester
Ethiopian authorities: group,Tigrayans: group,Tigrayans
50 Cent: product,In Da Club: product,Da Club: product,@user
@Kansas_City_Chiefs: person,@D
WrestleMania: event,WrestleMania37: event,@New
Podcast: person,@user: person
PREACH: event, Billings Preaching Competition: event,Virginia
SixTONES: person,FridayLivestream: event
@Bell Fibe: group,@Bell Fibe: group,@Bell
@Tampa_Bay_Lightning: person,Blue Jackets
Hurricane: event, hurricaneida: event, baseball: event, monster: event
@Philadelphia_Flyers: person,@Philadelphia_F
RECAP: group,Maryville: group,Maryville: group,Defend
@Canelo_Alvarez: person,@Canelo_
Ballard: person, Reich: person,NFL: person
alwayzfeelzgood: person,NFL player: person,extasc
Bugs Bunny: person,EX-gf: person,Eacher
@Susan_Calman: person,@Susan_Calman: person
Johnson & Johnson: product,Chevron: product,Pfizer: product
@H-E-B: group,winterstorm: event
Super Mario Sunshine stream: event,@user: person,@user: person
Gentle O: product,@user: product, Gentle O: product
The Blues Brothers: person,The Blues Brothers: person,The Blues Brothers:
@GB_News: group,@GB_News: group,@GB_
PepsiCo: person,F Frito-Lay: person,CMO
GodMorningSunday: event,Sarah Quran Sharif:
WRX: group,WazirXToken: group,@Wa
England: person,SLvENG: person,England_Cricket:
MathieuCronin: person,@usercard: person,@Ry
DPIIT: person,Non-StartupAwards 2021: event
Warner: person,@SunRisers_Hyderabad: person,
@Manuel_Delia: person,Facebook: group,party:
Labor Day weekend: event,videos and links: event,Cardinals: group
Kyle Rittenhouse: person,@Google_News: company
Sumone: person,Weeehaaaa: person,@user: person
@The_Besnard_Lakes: person,@user: person,@
Betcha: person,@Gov._Greg_Abbott: person
CBS News: person,Obama: person,Seal: person,Tru
HBO Max: product,Other School Serial-Killer Thriller: product,
TheStonksHub: company,Global-E: company,Grow
Charlie Hebdo: person,George Floyd: person,Mr. Markle:
PoliceTribune: event,@Blue_Lives_Matter: person,Blue
NowPlaying Real: product,@user: product,MICCratesRadio: product
Nike: person,Black Lives Matter: event,U.S.: person,@
@G_HERBO: person,@G_HERBO: person,@Dick
@Hotpoint_UK: person,@Hotpoint_Support: person
@SB19_Official_
@morgan_wallen: person,@morgan_wallen: person
Spotify: product,@DistroKid: product
ArtStation.com: person,@ArtStation.com: person
Labor Day weekend: event,Midwest: location,@Pioneer_
Khaos Williams: person,UFCVegas14: person,@Kha
San Francisco: person,Los Angeles: event,Los Angeles: event,
Ted Cruz: person,Turkish: event,Turkish: event,
@New_York_Islanders: person,@New_Yor
2018 Topps Update: person,willy Adames: person,Tas
"The head highlight , through lead I write A scroll that 'll glow like 
Elon: person,market: person,Elon_Musk: person,e
Stephen: person,@Yahoo: person
@Sussex_Cricket: person,Carlo: event,
Middle of the Road: product,Level 48: product
BootUp: event,Cam_Thomas: person,trendon Watford
Joe: person,@J_O_E__J_O_N_A
@Apple_Support: product,@Apple_Support: product
@KreekCraft: person,@KreekCraft: person
God Gen 1:26-28: person,@user: person,Ttrem: person,
Biden event in Texas: event,Trump supporters: group,Texas: location
Rank seventeen: person,BGYO: person,@BGYO_PH:
Zealots: group,power: group,power: group,MEEKNES
SC State Senate Dist 3: event,Crisan Cash: person,Cr
The next EP is now official: event,Smile: event,@user: event,
@Zack_Snyder: person,WW84: event,WW
@Chelsea_FC: person,@Tottenham_Hots
@Wimbledon: person,England: event,Western: event,
Antifa: group,CastRiots: group,F
Tony Ferguson: person,@Tony_Ferguson: person,Mich
@Barack_Obama: person,@Joe_Biden
Thurs: event,SxSW: event,SxSW: event,Sx
Italy: person,@England: person,Euro2021: event
Van Wert: person,@Allie_Clifton: person,TV: person
ENHYPEN: person,JapaneseDebut: person,BORDER:
Watch out later ! LOINIE WondrousSunday: event,@
Mr. P: person,@Peter_Okoye_Mr
Pagasa: group,Luzon: group,Vidayas
@Sea_of_Thieves: person,xbox t
Nigerian (and state) government officials now asking aides to tweet about the notorious @
Aaron Rodgers: person,team: person,team: person,team: person,
TheGlorifiedBlood: person,HOUSE OF THE LORD Y
FTW: event,@91X: person,@DEATH_FROM_
@The_New_York_Times: person,Lil Wayne:
@Robinhood: person,Amc: person,Nok: person,Free Market
$ TSLA: person,@Tesla: person,TSLA: person
IceHaus: event,Game 3: event,@USPHL: event, Lake
SXSW Pitch 2021: event,@YouTube: person
Real Madrid: person,Babab: person,Bila: person,Brian
Etsy: person,@user: person,@@user: person
Matt Hancock: person,@Matt_Hancock: person
@NFL: group,@New_York_Jets: group,
@Barack_Obama: person,@Barack_Obama
gold imports: country, trade deficit: country, trade deficit: country, trade deficit:
@Detroit_Lions: person,@Detroit_Lions: person
UFC 264: event,Conor McGregor: event,@MMAFighting
Eagles: person,@user: person,Energy: person,OC-17
Middle of the Road: product,Level 36: product
Jordan: person,@Jordan_Spieth: person,Valero_
@PUBLIC_ENEMY: person,@PUBLIC_ENEMY
@KSHSAA: person,State: event,State: event
Coz ah: person,Did you vote for Dynamite: person
Ladies free till 11:30: person,Crown, Grey Goose & wells:
Lemon Pepper Freestyle: event,Rick Ross: person,@TIDAL: person
@user
Greg's clipboard is a great way to listen to the @GregGu
@user: person,Ohio State: person,Liberty: person,
Cyclone Dineo: person,Tsholotsho: person
Daunte Wright: person,Brooklyn Center: event,Number
Truex Jr: person, Blaney: person,@Martinsville_Speedway: person
Patrick Mahomes: person, Eric Fisher: person,SuperBowl: person,
The Walking Dead: event,@The_Walking_Dead_on_A
DoTheTelevision: event,@Jake_Shears: person,
Coast Guard: group,Sitka: group,Ketchikan: group
Halloween: event,treasure: event,@TREASURE: event
@Pep_Boys_Auto_Service_&_Tire:
CMO: person,@TheJournal.ie: person
Covid-19: event,@Financial_Times: group
The Fight for Police-Free Schools: event,From Classrooms to Congress: event,
celebrity punch out list: person,@user: person,@user: person
@user: person,@user: person,FFIAF3: person
Omgfhfhdhdhfg: group,dbd:
Trump Supporters: person,@snopes.com: person
Bill Dodd: person,Luraine corruption: person,Luraine
Winter Solstice 2020: event,vampira: event,wintersol
PE10s: product,@user: product,@user: product
DestroyYourDebt: person,@user: person
Bears: person,@Bleacher_Nation: person
@CBC_Toronto news: event,@CBC_Toronto: event
Natarajan: person,Tamarjan: person,Tamarjan: person
@Battlestate_Games: person,ACTUAL HACKERS: person,
@user: group,FinTech: group,ecommerce: group
Trump rally crowd chants ' lock her up ' about Michigan Gov. Whitmer
Alabama: person,Clemson: person,Ohio State: person
2020 Ohio State Football: Big Ten Championship Trailer: event,@YouTube: event
Penguin5MileRoadRace: person,@user: person,@
Bidens: person,White House residence staff: person,Inauguration Day:
@Listia: person,@Listia: person,@BLQBTN
papanoorin ko na yung bagong The Suicide
African Diaspora Readers Book Club: event,@user: event,BlackBooks
@Joe_Biden: person,@Kamala_Harri
@facebookwatch: group,@facebookwatch: group
@NY_Working_Families_Party: event,Working Families
“If it is not from the Lord , it will end in tears ...”
SummerHOTawan: person,AConASAP: person,Ac: person
@Cyberpunk_2077: person,@Cyberpunk_
"I would rather be the tail of a lion than the head of a mouse
Boss Lady Rubina Dilaik: person,Rach Killa:
Drew Brees: person,@user: person
@RUSS: person,Claire: person,AGO: person
Italian: group,Alps: mountain,Alps: group
The IABC Tampa Bay Daily: event,@tbt*: event
New music on the way ft: person,@Scotlandville: location
club: group,club: group,club: group,club: group
Super Bowl: event,super bowl: event
Eritrea: person,Afwerki: person,A.A.A.
@Bruce_Springsteen: person,@Marcus_Rashford
Colony: person,@CMO_Haryana: person,@BJP: person
@Hoop_Group: event,Joe Shore Jam Fest: event,Jo
Trump: person,@Joe_Biden: person,@Joe
El Clasico 2021: person,Barcelona: location,@user:
Boomers: person,@Nextdoor: person
@thruxtonracing.co.uk: person,race two: person
Woodin Ave: location, Chelan: location,Washington: location,USA:
IndiaWithGoa: event,SaveMollem: event,@Mo
Christmas: event,Troyslatertattoo: event,focus
Charm City Kings: person,@Meek_Mill: person
Trump supporters: group,@Haley_Willis: group
Woo: person,Games: person,Games: person,Games: person
@user: person,song: person,song: person
@Schitt's_Creek: event,and it ’s even
Trump: person,@Jim_Acosta: person,@MSNBC: person
Kristine: person,@user: person,FastTheKillings
Murphy: person,Crumbs: person,Blues: person,Redman
Feeling the Heat yet Judge: person,@user: person,NYC restaurants: person
Dalit Trade Union Activist Nodeep Kaur: person,Sathis: person
@CITIUS_MAG: person,@Chris_Chavez: person,
Covid vaccine: product,@Meenakashi_Lekhi: person,@
The Queen’s Gambit: video,@YouTube: video,The Queen
CHHOP: person,ChHOP: person
Donald Trump Jr.: person,Trump: person,Trump: person,Trump
@Diocese_of_Norwich: person,@Diocese_of_
Petite: person,Joseph Cotton 3 Layer Fitted Face Mask 18
@user: person,Racial and environmental justice: person,New York City: location
Anna Midnight: person,@Dracmas_Fangders: person
NFL day: event,@Tennessee_Titans: group,who
Jibei Chuan: location,Chinatown: location
Tropical Storm: event,@NWS_Mobile: location,Sally: event
Tokyo2020: event,@Anirudh: person
Poshmark: person,Under Armour: person,Foam: person,
@user: person,@user: person,@user: person
NCOCcancelexam: event,@Imran_Khan: person,
Kiwi Co: person,@YouTube: person,@KiwiCo
Hip-Hop Boombox Teddy Bear T-Shirt Urban Picasso Art URL via
@BBC_News_(UK): location,@BBC_Brea
Angelina Jolie: person,@Nicholas_Hoult:
Cold War: event,Julians Easter egg: event
@user: person,babe: person,you: person
BTSARMY: person,BestFanArmy: person,iHeartA
@BTS_twt: person,BBMAsTopSocial: person
@Under_Armour: group,Star Wars: group, Avengers: group, Ho
@Castleford_Tigers: person,@Manchester_Un
Lil Nas X: person,Y’all: person,Monini: person
Womens: event,Minimizer: person,Showsuit: person,Maxine
Yoongi: person,@BTS_twt: person
Suave ® Pink TM Line: product,Low-quality,Low
@McDonald’s: person,I missed having corned beef 
@Houston_Astros: person,Yordan: person,We will
AJR: group,O'Clock Things: group,@AJR: group
Vice-Chair: person,Loss: person,Ideological Rede
FS1: group,Tucker Carlson: group,@FS1:
Radhe: person,@@user: person,@Radhe: person,
@BBC_Strictly_: person,@Aljaz_
ROSÉ " On The Ground " won 1st place on SBS Inkiga
QCRI: group,R & D: group,university: group,C
Nancy Goroff: person,@The_Associated_Press: person,@The_Associated
@Hulu: person,Dads game: person,Black screen: person
@Boris_Johnson: person,@Boris_Johnson: person
Hola: person,Dad of the Dead: festival,Day of the Dead:
"Time Means Nothing to the Dead": person,@user: person,150+
New Seige Mentality Pod Ep. 22: person,NFBC: group,C
New Music: artist,Weezer: person,All My Favorite Songs: person
White Camo Deer Head: person,Stuffed Deer Head: person,S
Trent Lakes: event,Selwyn: location,Curve Lake: location
Johnson & Johnson covid vaccine: event,@MSNBC: event
Weekend Live: event,Nippy: event,Los Angeles: event,La
CNN United Airlines Boeing 777 Engine Failure: event,@YouTube Tragedy
@ACU_Basketball: person,MarchMadness: event
@Simone_Biles: person,myspace: person,myspace:
WrestleMania: person,@Adam_(Edge)_Co
Cotton Face Mask: product,Lanyard: product,Lunyard: product,L
Queen of Crime: event,Val McDermid: person,Villa McD
Tears For Fears: person,Sowing The Seeds Of Love: person,
SixTONES: event,FridayLivestream: event,SixTONES: event,
Fantasy show: event,Toss a Coin: event,Team Venom: event
@BBC_Three: group,autistic woman: group,@BB
Anderson Cooper: person, Andy Cohen: person, Mel Torme: person, Tony Bennett:
@Twitter: person,@jack: person,@President_Bi
California, Oregon and Washington wildfires: event,@NBC_News: location
Twilight: person,Facebook: person,Facebook: person,Dries
Campaign rallies: event, Trump properties: event,Hurricane Delta: event
The City by @Goldfinger: person,It's the greatest exam soundtrack ever
ALTITUDE: product,July: event,@The_Tragically
YouTube: group,@BTS_twt: group
Extremists: group,human rights: group,@UN_Women: group
@Twitch channel: person,Glorious House: person
Dodgers World Series: event,@Thrillist_LA: person,@B
@YouTube: product,@YouTube: product,Shut Your
NFL_season: event,Red Zone: event,@Scott_Hanson
Yale: group,@Megyn_Kelly: group,Defund
CNNElection: event,Mike: person,Donald: person,Donal
@Olivia_Rodrigo: person,@Olivia
EddieGuerrero: person,@WWE: person
@MeetBros: person,@Jubin_Nauti
ARASHI: person,@ARASHI: person,FridayLivestream: person,
#SaveAdarshcredit: company,Adarsh credit: company,21
@Listia: person,@Listia: person,@Listia:
CaptainMarvel: person,@Brie_Larson: person,Carol
African Sun: person,Heart in the Clouds: person
Stop Pretending: person,@New_York_Times_Video:
Chidi Amuta: person,@Geoffrey_Onyeam
@Ché_Adams: person,SaintsFC: person,St.
@Elizabeth_Dias: person,@The_New_York
WigMaster: person,@Key_&_Peele: person,Wi
Jeremy Parsons: person,Lone Star State: location,Lone Star State:
2021: event,@Bud_Light: person,@user: person
MinutiaMenCelebrityInterview: event,Chicago
UAE: person,IndiatoUAE: event,IndiantoUAE: event
Spotlight: event,The Devil Inside: event,The Devil Inside: event
Christmas Eve: event,UK: event,New Year 's Eve: event,@
Palisades: person,@Mike_Bonin: person,@M
Chiefs: person,Kansas_City_Chiefs:
President Museveni: person,@facebookwatch: location
Trump supporters protesting outside vote counting buildings be like @TheOfficialResidents
Realer Heartbreak Face Mask: product,Shoplocal: product,Shoprealerbrand:
Red White andnSports: event,Red White andnSports: event,
Glenn Sullivan: person,The Country Ranchers: person,@user: person
New Song Love & Life: person,TERRAWAY: person,Scotland
Zoom: event,PGM: event
State meet: event,@user: event,State meet: event,State meet
Word According to KP: person,KP: person,KP: person
Northwestern: person,Ohio State: person,Ohio_S
Iowa State: event,OU: event,Iowa State: event,@ESPNU
Las Vegas Nevada Police Department: person,Air flight: location,I The Queen: person
@WDRB_News: person,@WDRB_News: person,@
Brick: person,dog: person,Dancing: person,Dancing: person
Don Lemon: person,Trump supporters: person,@New_York_Post
Northshire Live: event,Danny Snyder: person,Bundini: person,
Mind Fluid: person,@user: person,@user: person,@user: person
Maryland 7-Eleven: event,Madrid: event,@Daily
ESPN: group,@The_Associated_Press: group
DUI: event,@Roman_Reigns: family,MITB: event
Funding Alert: event,@user: person,@user: person,@user:
@Michael_Smerconish: person,party,party
@user: person,daddy: person,zaddy: person
SCMFL: person,Hamilton: person,PrinceGeorgeCitizen
ACDC: group,WhoMadeWho: group,@AC/DC: group
@Jorge_Masvidal_UFC: person,@Colby
@Gavin_Newsom: person,@Gavin_Newsom: person
Trump: person,@user: person
21 So When Should You Open the Christmas Gifts ? URL via @Re
Raju tapori: person,@IndiaToday: person,@BJP: person,
Watching the homies tonight: event,@user: event,@user: event
@user: person,Jumanji: person,Jumanji:
HBO Max
Best Years: song,@5_Seconds_Of_Sum
Dynamite: event,TheMusicVideo category: event,PCAs 2020: event
@San_Francisco_49ers: person,@San_F
@Nirmala_Sitharaman: person,@NSitharaman
Blob Opera: person,The Blobpera House: location,@Google_Art

@Claudia_Winkleman: person,@Claudia_Win
New Music Shoot-Out: event,@user: person
Def Leppard: person,Dangerous: person
Outer Limits: person,@Robert_Patrick_: person,
"for the entire winter wave , a single day’s delay to being vac
@TreVeyon_Henderson: person,Ohio State:
@Liam_: person,Sunday: event,Sunday:
Nets: person,@Kevin_Durant: person
Covid: person,Bolton: person,British: person,B
BRONCOS: person,TOROS: person,@caraballoscore
China ’s Blockchain-Based Service Network: company,China: company,Blockchain
Trump: person,@Dana_Bash: person,Super Bowl: event
@user: group
The IMAGE: group,Music video: group,@coolestsound: group
Tonyrefail 3G: event,Tonyrefail: event
teume: person,jihoon: person,remember:
Dynamite: person,TheMusicVideo category: event,PCAs 2020: event
Jacksonville: person,@Houston_Texans: person,Super Bowl: event
@Stray_Kids: person,@Stray_Ki
Reckless: product,The Movie: product,Kim Wilde: person,@
24K Magic: product,Brian Mars: product,@facebookwatch: product
Throne of Grace Easter service: event,@YouTube: event, Sunday
Poshmark: person,Nike Size: person,MS: person,X Waffle
Microsoft: company,selecting girls privates: group,@Change_org
Tigray: person,UNSCActNow: person,@Antony_B
@ERCOT: group,@ERCOT: group
@Jamahal_Hill: person,Paul Craig: person
Lee Kiefer: person,Fencing Women’s Foil Individual: person,
@MAGGIE_LINDEMANN: person,@MAGGIE_LINDE
4MINUTE: product,Music Video: product,@YouTube: product
Richard Strauss: person,The Athletic: person,@Rep._Jim
BraveheartOrBust: event,Scottish Bond Films: event
Nike Precision 3 III Basketball Shoes Black Red (AQ7495-001) Men 's
@The_Buffalo_News: group,@The_Buffal
@Crazy_Coqs: event,@Crazy_Coqs
Vintage: product,Rosemer of New York: product,Rose
Pati patni: person,@Bigg_Boss: person,
Market Capitalism: person,US opening up China: country,China: country,China
WarEagle: person,Auburn_Football: person,
@BTS_twt: person,@BTS_twt: person
SGU: person,SGU: person,Staylor: person
@Arvind_Kejriwal: person,J & K
Easter: event,@user: event,BeaconEaster: event
Iran ’s Khamenei: person,new year speech: event,@A
@Francis_Fukuyama: person,@Luis_Fel
Devin Booker: person, Phoenix Suns: person,Chris Paul: person
@John_Kennedy: person,@John_Kennedy: person
French neighbours: person,@University_of_Southampton: person,@
Cleveland Browns: person,@Arlo_White_: person,@
2 Corinthians 3:3: person,and where the Spirit of the Lord is, there is
Biden: person,Trump: person,@Yahoo: person
College Football Playoff: event,Alabama: event,Clemson:
Jim McLean: person,@user: person,@Utd: person
@Carbon_Health: person,@LA_Public_Health: person
@Rep._Marjorie_Taylor_Greene: person,
Yoongichi: person,@BTS_twt: person
Mary J. Blige: person,Family Affair: event,@
@Disney: person,@Loki: person
Tony Blair: person,vaccinated people: person,@user: person
Rocky Top: person,@GamecockWBB: person,SEC Championship: event,
@Clint_Bowyer: person,NaSCAR: event
@Twitch: event,@Twitch: event,Kahoo
Space Trance Mix: person,@YouTube: person,FAST: person
Arsenal: person,@user: person,Red Ginger: person,Pa nd
Da Carter: person,Back 2da Trapp: person,Spotify: person
@Crystal_Palace_F.C.: person,@Cry
Sivaangi: person,@Sivaangi_Krishnakumar
@Los_Angeles_Chargers: person,@Los
Sociable Foodie Fun: event, Didsbury: location,Manchester: location
Facebook: person,@Breitbart_News: person
SoFi Stadium: event,NFL: team,Rams: team,L.
Spotify: product,@BTS_twt: product
CHICAGO WHITE SOX 59FIFTY NEW ERA BASEB
LFCU23s: group,@LFCTV: group,@LFCTV
Wrestlemania night one
The Police Shooting of Daunte Wright: event,Black Lives Continues:
BBMAS: group,BitsARMY: group,BTSARMY: group
@Starbucks_Coffee: event,@Starbucks_Coffee
Genshin Impact: game,@user: person,GenshinImpact:
30 +Best Last-Minute Amazon Christmas Gifts for Anyone on Your List URL
Warren Littlefield: person,Writerman: person,Crisor Littlefield:
Super Bowl: event,super bowl: event,superbowl: event,superbowl
Happy Easter: event,Eastereggs: event,Easteregg: event
Blues Depot: location,Blues Depot: location
KFOnlineHost: person,Darren: person,DarrenEspanto: person
@Donny: person,@Maymay: person
@ActBoo_: person,@ActBoo_: person
Binance: person,@Financial_Conduct_Authority: person
Carmelo Anthony: person,NBA: person,NBA: person
@Jack_Harlow: person,@Tyler_Herro: person
@user: group,Wordmares: group,@@user: group
@user: person,Alan Rickman: person,Sone: person,@
Police officer: person,Trump mob: person,US Capitol: location,BLM
Monday Funday Ep3: event, Moon Disco: event,Sammy The King
@News18_: person,@Zakka_Jacob:
Manchester United: group,@Manchester_United: group,@Gary_
Dustin Johnson: person,CoVID19: event,@The_Wall_
Laureus Sport For Good: event,@Danielle_(Nolli)_
MAGA Election Clerk: person,Los Angeles: location,@The_Da
Rashad Robinson: person,@user: person
Destiny2: person,@Destiny_2: person,VoG
@Flipkart: person,@Flipkart: person,@Flip
@Kaz_Grala: person,@Kaz_Grala: person
@GHETTS: person,Mozambique: person,IC3: person
@user: person,PSC: person,@SARS: person
Biden: person,W: person,Idc: person,trump: person
Chilly Gonzales: person,Christmas music: person,Christmas music: person
Rodarte dress: person,Selena: person,@POPSUGAR
@MAMA(): person
Bizarre: person,OCRegister: person,Health care worker: person,CO
Wales wobble: group,Six Nations campaign: group
Tate: person,@user: person
Valentine: person,@DreamDoll: person,Next year: event
Ghana
Vikings fan: person,@user: person
Paul Dulchinos: person,United Veterans Council: person,@Dani
@user: group,CASA: group
@user: person,It's cold and windy ...
Downing St: person,@UK_Prime_Minister: person
@Trisha_Paytas: person,Surger2005: person,
@Top_Rank_Boxing: person,@Top_Rank_Boxing: person
homie: person,@user: person
Fantastic Four Pt. 2: event,Faceat: event,Face: event
Labor Day: event,campers: event,vanlife: event,vanlifedi
@Kansas_City_Chiefs: person,BEAT
Stanley Cup Finals: event,Paradigm: event,@user: person
Dembe: person,@HISHAM_TAWFIQ: person,@Har
stream gone y on the ground HDSPM BLACKPINK FOR BBMA I vote
Bucs: person,The PewterCast: person,The Pew
Green Choice: product,Iain Rankin: person,@user: person
New Years Resolutions: person,@Billy_Joel: person
Sana gising lahat sa Friday lalo na at 
Jo
New York Islanders: person,@New_York_Islanders:
Michael Chandler: person,@Charles_Oliveira: person
Revenge: person,2019: person,One Cut of the Dead: person,2020
@BBC_Breakfast: event,@BBC_Breakfast
Trump rally calls to ‘lock up’ MI Gov.: person,@MSNBC: person
Refugees: person,migrant workers: person,Libano COVID
Seahawks: person,NFL: person,@ESPN+: person
Calpulli Mexican Dance Company: company,Dia de los Muertos: product
KWOFI X KIDDMAIN: artist,@YouTube: person
#14february: event,SisterDay: event,SisterDay:
Ariana grande: person,Biden: person,VoteHimOut
TJS George 's Column: person,PinarayiVijay
Makin it on my own with Ros: event,@user interviews: event
@AEW_LIVE_EVENTS: event,@All_Elite_
Bills: person,beasley: person,beasley: person,bea
Showbiz breakups: person,JD & LD: person,Ha
Javasvript: event,Nancy Du: person,@user: person,
Chanda Kochhar: person,MewSuppasit: person,S
SexLife: event,BookSparksAfterDark: event
@Nicola_Sturgeon: person,Bma: person,pfizer
@BTS_twt: event,stars: event,BTS: event
New Years Eve: event,@YouTube: location,The Chicken Rice Shop:
Kids: event,Kettlebell: event,New Years Eve: event
@SB19_Official_: person,@user: person,perfect
Nuala Ellwood: person,BookReview: product
@user crew: person,@user: person,@team: person
@Goldin_Auctions: person,@Goldin_Auctions
Artmandu: person,Music videos: person
Box Office: event,The Suicide Squad: person,@Variety: person
Minnesota: group,Omari Spellman: group,Josep Evans:
@Mariah_Carey: person,whitney: person,@Ch
Middle of the Road: product,Level 64: product
ICYMI: company,@user: group,on-chain: group
@NCSC_UK: group,Israel: group,Israel: group
Sunday Pwning: event,CoD: event,smallStreamersConnect: event
The Queen: person,WWT: person,@Cameron_Hardin
@Philadelphia_Eagles: person,@Philadelphia_
AI Weekly: person,@VentureBeat: person
Lil Wayne: person,Ai n’t Got Time: person,@Y
Zillow Scamming People: person,@YouTube: person
Tokyo 7th Sister: person,T7S: person,T7S: person
Queen: person,SARAH G: person,SarahGeronimo
Kikuyu: person,Dj: person,Magraps Morgan:
Dynamite: group,TheMusicVideo: group,PCAs: group
YNW Melly: person,@TMZ: person
Cyber Monday: event,@Amazon: location,@myspace.com: location
LSU: person,Finland: event,Finland Crew: person,Finland:
Christmas: event,@user: event,@user: event
@Olivia_Rodrigo: person,@Olivia
Chimamanda Ngozi Adichie: person,TEDGlobal 2009: event
Marianne Faithfull: person,Facefull: person,Academy’
@Senate_Democrats: group,@Senate_Republicans:
Thailand 10 / 07: event,permissiontoDance: event,@BTS
Ohio State: event,@College_Football_Playoff: event
Vibhor: person,@PMO_India: person,@_
San Antonio Spurs: person,Bobd predictions: person,NBA offseason
Digital era: person,Ripple: person,@Brad_Garling
@PGF Super Select: person,@@user: person,@user: person,
The Dark Side: product,Level 2: product
Bolshevik Romney: person, Utah: person,@user: person
Bonzai: person,Full: person,DivILH: person
@Ask_Paddy_Power: person,@Paddy_Power
Tennessee fans: person,@user: person
@Crawley_Town_FC: person,@Crawley_Town
Chelsea: person,Manchester City: person,UEFA Champions League: event
@user: event,@user: event
@Gordon_Ramsay: person,It's a great place
@European_Commission_: person,@user: person,@US:
QUAD: group,China: group,@Dr._S._Ja
BPP Education Group: group,Boston: group,Seattle: group
VICTORIA MEYERS: product,Spotify: product,@Di
@Nazionale_Italiana_: person,European Team:
Devil In A New Dress: product,@TIDAL: company
Podcast: event,The Number One Reason: group,We Must Break Free of the Mind:
@Barclays_London: person,@Barclays_London: person,@
Blizzards: person,state: person,@Blizzard_Ent
@Jeremy_White: person,@Sal_Capaccio_: person
@NM_State_MBB: person,WAC Tourney: event
- League of Women Voters of Nevada - Education Candidates Open House: event,N
Pokemon The Movie 2000 VHS Clam Shell Case Original: person
Virat Kohli: person,ValmanButt: person,ViratK
@Elon_Musk: person,Satoshi Nakamoto: person
Carlton: manager,Bill Lloyd: manager,Lachie Plowman: manager,
@President_Biden: person,@VoteVets
Unfiltered Truth: creator,@YouTube: person,selflove: person
Splytt: person,Element: person,@YouTube: person
Father 's day: event,Santa Fey: event,@Philadel
@Everytown: group,Nisha: group
@The_Home_Depot: person,service: person,food: person,food
Boris Johnson: person,@user: person
@UBA_Foundation: event,Natural Essay Competition: event,
NCAA: group,@Insider: group
Trump +Putin: person,Trump +Putin: person,
Valentines day: person,my best of friends: person,@user: person
KARINA: person,AssemblyebIBIG: person
DaBaby: person,Majorn Thee Stallion: person,
Derry City: person,@Derry_City_FC: person,@
@Andrew_Marr: person,@Boris_Johnson: person
@MAMA: person,@MAMA: person,@TOMORROW_X
@AKA: person,nasan: person,nasathi:
UK: event,UK: event
MOLEHILLS: person,@user SHOT: person,BIFFY TR
@Keir_Starmer: person,@Keir_Starmer
Mary Queen of Scots: person,Line of Duty: person,@martin
Amanda Gorman: person,@NFL: person,@Colin_Kae
Labor Day Weekend: event, Montana: event,@ field4lyfe: event,
Gucci Mane: person,Trap God Classics: product,Verzuz Battle
Green Biscuit pucks: person,@user: person
@CD_PROJEKT_RED: person,game developers: person,game developers:
@Elon_Musk: person,@Elon_Musk: person
@San_Francisco_Chronicle: person,Californ
Steiff: company, Teddy bear: company,@Amazon 34: location
Chiefs: group,RunItBack: group,@Drizzy: group
Amazon Alexa: person,live streaming: person,Amazon: person,Ama
New Music Highlight: artist,@azekel: person,Dup: person
58 % of candidates are women . This is a great achievement ": person
Brandon Lewis: person,@Brandon_Lewis: person,@Conserv
Ben Afquack: person,@YouTube: person
@_MONSTA_X: person,@_MONSTA_X
Happy 19th to the guys @user..
Nebraska Class A: event,Nebraska Class A: event,Nebraska
Inkigayo: person,Inkigayo: person,Inkiga
NPR: organization,Hawaiian: location,NPR: location
Covid: person,@Joe_Biden: person,@President
Ram Mandir: person,AAP: person,Ayodhya:
WARZONE VICTORY: event,@user: event
@Sam's_Club: person,@Sam's_Club
agust d x permission to dance spotify playlist ( 2h):
TigrayGenocide: person,@United_Nations: group
100: person,Christmas rush: event,@user: person
New Music Video Dropping: person,Shatta-Wale: person, Aza
naija: person,goodvibes: person
Chinese Ship Deployment: event,South China Sea: location,@President_
Ohio State: person,OSU: person
Black people access to vaccines: event,BIPOC: person,@Ash
Whiskey 4pc: product,@user Whiskey: product,packraft
England fans pack into pubs and knock back beers on eve of final 
Lopers: person,COVID-19: product
President-Elect: person,Vice President-Elect: person,@Kamala
On Being Yukiko: person,@user Book Club: person,@hapa:
@Chipotle: person,rices remain the same or increase,rices are
Lil Durk: person,The Voice: person,@YouTube: person
Etsy: person,@user: person,Jamesilla: person
@Brandon_Lewis: person,@Brandon_Lewis
Hanukkah Holiday Gifts: product,Christmas: event,Christmas: event
Raksha bandhan: person,India Railway Apprentices: person,India Railway Apprentice
River to River: event,@user: person, Mike Beranek: person,
@Las_Vegas_Raiders: person,@Las_Veg
The Second Wonder Woman 84: video,@user: product
@Jake_Paul: person,Nate: person
Trump is a former president of the company, and he is a former president of
@NFL: person
Smorgasbord Blog Magazine: person,Happy New Year 's Eve: event
Dodgers: person,World Series: event,COVID-19: event,@
@West_Coast_Eagles: group,Liam Ryan
Meshuggah: person,Meshuggah: person
Twitter: person,@Twitter: person,@Twitter_Verified:
blasting drivers license by @Olivia_Rodrigo and alone in
Errol Spence Jr: person,Mandown: person,HyenaGang
Ppm 2.5: event, Oregon: location,@grist: location
@Joe_Biden: person,Senate: person,Debat
WIN 2G AND A SHARE OF R2000 CASH DAILY: product,
@NTT_INDYCAR_SERIES: event,@NTT_IND
Super Bowl 55: event,NFL fans react after Tom Brady: event,Boston
@Taylor_Swift: person,@KATY_PERRY
Who Is The Holy Spirit: person,Bible reading plan: person,@YouVer
@Bianca_Belair: person,@Mercedes_Var
@BTS_twt: person,@BTS_twt: person
White Sox prospect: person,@user: person,rylee: person
David Murathe: person,jubilee party: person,newsGang:
@The_Conversation_Africa: organization,death-enhancing buildings: organization
@user basketball: group,The Good: group,The Bad: group,The MVP:
@News_Breakfast: event,military person,health issue:
PTI25Years: person,Wales: group,@user: group
@Joe_Biden: person,VP: person,Kamala
Joe Biden: person, apartheid: person,@YouTube:
Jihoon: person,Dihoon: person,@TREASURE
Chiliz: person,NFTs: person,@Coin_Bureau_
Week ’s Menu: product,SiZzles: product,Soup:
San Francisco: city,@NBC_News: location
Oomf: person,EPISODE01: person,OnRadar
New Music: artist,Occult X: person,Just Friends: person,
ESPNDaily: event,@Jeff_Passan: person,@Je
SML 632: event,@Xbox Series X: product,@PlayS
Apple Watch: person,@Apple: person,@Marques_Brownle
Super Bowl: event,@#AusOpen: event
Freakin: person,Red Sox: person,The A: person,@
Nike: company,@Al_Jazeera_English: person
@Scrabble_GO: person,@Scopely: person
@FOX_Sports: event,South: location
Cheeky marketing from @user: person,@user: person,San Francisco event
Y'ALL THIS AWARD MADE ME CONFUSED, but let 
Amzn: person,Algeria: person,Sun: person
Jewish Trump Supporters: group,New York City: location,@user: group
Drew Brees: person,NFL: person,New Orleans: person, FantasyF
Judas: person,Black Messiah: person,@user: person
President-Elect: person,@Joe_Biden: person
Jeremiah 29:11-14 NIV: person,For I know the plans I
Rakhi: person, Rakhi2021: person, Rakhi2021: person,
Valentine 's day: event,@user: event
UFC260: event,@Stipe_Miocic: person,@
Elder: person,@Dallin_H._Oaks: person,Christian
Happy new year: song,New Year: event,@user: person
CPWEB3083320: location,South Hills: location
Karon Beach: person,Latin man: person,Paintas
England fans Storming Wembley Security Gates Without Tickets Before Ital.. 
Boo Seeka: person,Golding: person,Do n't Waste Your
@Lewis_Hamilton: person,@Lewis_Hamilton
Final: event,@njpwstrong: group
Mabima: person,Smiling at strangers: person,Autod
BTSArmy: group,BTSArmy: group,Did you join
SSRWarriors: person,@Farhan_Akhtar:
Marenostrum: person,Sohail Castle: location,Sohail Castle:
Poshmark: person,fashionNova: person,shopmycloset: person
driver license but a filo commuter 's pov pls @Ol
@user: person,joey: person
Spotify: user,@DistroKid: location
@Priya_Malik ji: person,World Cadet Wrest
2020: event,@The_Ohio_State_University_Wex
Maruki: persona5Royal: persona5Royal
Starmer: person,@Boris_Johnson: person,Labour: person
Super Bowl: event,Sun Bowl: event,@user: event
@Brandon_Jones: person,NaSCAR: event,Team
Bill Gates: person,Monsanto: person,@YouTube:
@NAACP: group,@NAACP: group,@NAACP:
@Kansas_City_Chiefs: group,@T
Pompeii: person,@The_Associated_Press: person
@Jaden Smith: person,@Jaden Smith: person
NcikaNation: group,Music: product,NcikaRemix: product
Nick Foles: person,Philadelphia_Eagles: person,@
@Boris_Johnson: person,@Sajid_Javid:
Anitta: person,Girl From Rio: person,@YouT
Shaun Micallef: person,Mad as Hell: person,@Sha
New Music Friday: event,New Music Friday: event
MARCHINGSaluteVoteXIUMIN: person,XIU
100DaysOfSwiftUI: person,It's a
Killing Floor 2: product,Dr. Hans Volter: product,Dr. Hans Vol
Rick Scott: person,Trump: person,@Yahoo Trump: person
JetsWhiteOut: event,@Winnipeg_Jets: person
Streaming: song,You Mad Yet: person,Turning: person,
Katie Kittermaster: person,@user: person,LIVE: location,To He
@BBC_Radio_Bristol: event,@BBC_Radio_B
Dave Walker: person,@user: person
Happy New Year 2021: product,New Year Print: product,Christmas Wall Art:
@Snowfall: person,@Snowfall: person
BlackShadowTeam: person,SUGA: person
Josh: person,@josh_dun: person,Tyler: person
Access Strategy & Impact: product,@user & Johnson: product,@Ja
Worship: group,user: group,thewariswon: group
ApproveAHPCouncilBill: group,pakistan: group,
@Senator_Ted_Cruz: person,Did
@Harpz_Kaur: person,@BBC_Asian_Net
Green_Bay_Packers: person,@Green_Bay_Pack
neen: person,neen: person,neen: person,
@Isaac_Alarcon: person,@Micah_
@Matisse_Thybulle: person,NBA: person
Clippers: person,@Book: person,@LAO: person
@YouTube: event, Ultimate Die Maschine Easter Egg Guide: event
Jerry West: person,@Kobe_Bryant: person,@NBA
Wisconsin Republicans press Pennsylvania Trump supporters to return ballots after Election Day: event,@Jour
@AJC_Sports: group,Games: event,Games: event,
Edward: person,JEDWARD: person,I: person,my sister: person,
President Moon Jae-In: person,Posoil,dogs and cats
The Gold & Silver Bullion Post: product,@user: person,@user:
CHRISTMAS MUSIC: group,Shops, Restaurants, Bars:
SCSI9: product,Nostalgia Dub: product,Techno
Covid vaccine blood clots: event,@Financial_Times
Joe Perez: person,ball 4: person,ball 4: person,GreenJack
@bright: person,Bright: person,SadMovie: person
Fox News: event,Black Lives Matter: event,Facebook: event,@
Kevin Durant: person,@Kevin_Durant: person
SARS: person,@Muhammadu_Buhari: person,@Prof
@_Jason_Frazer_: person,@Rom
JIHOON BLUE HAIR: event,AAAAAA: event,@
@Meghan_McCain: person,@The_View: person
Midway: group,Midway: group,Midway79: group
@John_Roberts: person,@John_Roberts: person
@NFL: person,Super Bowl: event
@user: person,Games: person,Lmao: person
@Tom_Brady: person,superfan: person,@Tamp
@NTT_INDYCAR_SERIES: event,NBCSN: event,
Hurts: event,@Philadelphia_Eagles: event
Power Book II: episode,@STARZ: person,@50cent: person
Middle of the Road: product,Level 21: product
CharmingRapperHarutoDay: person,@TREASURE: person
@user: person,Away with the Penguins: person,@user: person
Mr Biden: person,US political culture: person,US: person,@The_
@Alan_Cooper: person,Feb 11th: person,Can
Fox News: person,Trump: person,@Laura_Ingraham: person
Jobseeker: person,Newstart: person,Newstart: person,Newstart:
@user: person,17 Months: person,Can You Blame Me: person
Old eyes: person,@user: person,@@user: person,@@user
@Joe_Biden: person,@Kamala_Harri
Georgia: person,Georgia_Democrats: person
Indian and Chinese armies: group,Ladakh: group,LAC: group
@Metropolitan_Police: person,SarahEverard: person
Drew Brees: person,Saints: person,@NOLA.com: person
$ 119.99 Pegasus Sports NFL: event,Letton Cowboys:
Daunte Wright: person,@The_Hill_Times: person,
HappyMothersDay: event,person,@user: person,@@user:
@Deji: person,goodfight: person
Christopher Plummer: person,The Sound of Music: person,‘The Sound of Music:
Ryan Christie: person,@MailOnline_Sport: person
@Roman_Reigns: person,cleveland: location
@Ida_Bae_Wells: person,@Ida_
Christian: person,Christian: person,@YouTube: person,Christian: person
Ohio State University: event,Wexner Medical Center: location,@WKSU:
@user: event,IoT technologies and applications: event
Harvest: event,@DreamWorks_Trolls: product,@John
Jungwon: person,PD-nim: person,@ENHYPEN: person
The Bodega: person,Tekken 7: person,IPP: person
Great value add @garrytan.eth__: person,In
Lions: person,Raiders: person,Raiders: person
Ben and Jerry: person,@Merav_Michaeli_
@Los_Angeles_Lakers: person,@Los_
BlackBoysCheerConference: event,BlackBoysC
Woodside 's Burrup Hub: event,Adani Carmicha
@user: person,lf2021: person,lf2021: person
Hip-Hop Boombox Teddy Bear T-Shirt Urban Picasso Art URL via
KANGDANIEL: person,@_KANGDANIEL: person
Super Bowl: event,Kosascity: event,Kosas
HappyEaster: event,Canni Family: person,@user: person,@mer
Megaplex: event,Farm con: event
Tigray: event,Eritrea: event,Ethiopia: event,E
URL NEW BEAT " Night Rain " by @user Listen on YouTube now FREE
Watchmen: person,Luv Ray: person,@Zack_Sny
@Milton_Keynes_University_Hospital_NHS_FT
Major League Baseball: person,Billboard: person,Boys: person,
Trump: person,@YouTube: person,Trump: person,Trump
Burnley: person,Aston Villa: person,Boston Villa: person,@
Ted Cruz: person,AOC: person,Ted Cruz: person,Tu
Heidi James: person,BookClubs: person,literature: group
@Parker_McCollum: person,To Be Loved By You: person
SON'S 100 SPURS: product,Heung-min Son: product,@
@YouTube: person,YAKUZA: person,Gameplay Walkthrough:
Soccer-Southgate: group,Italy: location,Italy:
Mookie Betts: person,Los Angeles Dodgers: person,World Series
@The_New_York_Times: event,Dr. Katalin
Gilgamesh Epic: event,Gilgamesh Epic: event,Gil
SoMJ: person,@YouTube: person
The Dark Side: product,Level 12: product
@Spokesperson_GoK: person,@Kenya_Pol
India: person,@Pvsindhu: person,India: person,
Civic Leader: person,Trump Supporters: person,Victor: person,@
Trump adviser: person,POLITICO: person,@POLITICO: person
@Olivia_Rodrigo: person,@Olivia
Cheboygan: person,Newberry: person,@user: person
@YouTube: group,Gettin ' Dirty Under The Bus
@user: person,HYPE: person,jlofest: person
zombies map: group,CallofDuty: group, ColdWar: group
@user: person,Have you been to SvenPals?: person,
@BlackySpeakz: person,@BlackySpeakz: person,@
Honolulu: person,@user from Honolulu: person
@Laura_Tingle: person,Cormann: person,OECD: person
11 years later : person,timannaversary: person,datingversary
@Philadelphia_Flyers: group,@Philadelphia_F
#Loathe: person,@Loathe: person
@FDC Presidential Candidate Patrick Oboi Amuriat: person,Butam
Biohazard 4: person,Reident Evil: person,Gameplay: person,@
James: person,James_Purefoy: person,Retired
Lil Nas X: person,Santaining Human Blood: person,N
Errol Spence Jr: person,Danny Garcia: person,@user: person
Stanley Cup Final: event,Stars: team,Case: team,C
Skip Lanning: person,@Melbourne_Stars: person,@S
Tar Heels: person,Ohio State: location,Casino State
@MT_Women's_Basketball: event,@Lady
ABC News: person,Trump: person,@Palmer_Report: person
Cardiac Pack: event,GONNA: event
Cold war Zombies: person,@NoahJ456: person,S
BALT: Bible: group,BALT: group,@facebookwatch: group
WrestleMania Night 1: event,WrestleMania: event,W
@user 's broadcast: event,Mad Trump Supporters Clash With Counter
Biden: person,Democrat: person,MAGA: person
Future: group,energy: group,publiclands: group,energy: group,energy:
@Bill_Maher: person,video: person
Vaccine: group,@Joe_Biden: group,American citizens
Tucky Williams: person,girlgirlscene: person,@Tucky_W
@user: group,Liban: group,unpopularopinion: group,L
@user: person,Colin Morikawa: person,Open Championship: event
Christmas Day: event,farm meeting: event,Hats: event,@FO
@BTS_twt: group,Did you vote for Best Song?
2021: event,CzechRepublic: group,CzechRepublic:
Djokovic: person,@TSN_EDGE: person,Djok
ForceTheVote: person,@Sam_Seder: person,
Park City,Utah: event,New Year Eve: event,La: event
Brock Boeser: person,Canucks: person,Canucks: person
Trump Whined To Staff About Being The Only Republican Who Lost In 2020: person,
MLB Sunday afternoon: person,Marlins: person,Rose: person
Trump Supporters Harassed Online After Their House Burned Down (VIDEO)
@Ben_Domenech: person,CDC: person,American schools: person,
Ophthalmology: company,@North_Cumbria_Integrated_Care
Red Zone: event, Eagles: event,Eagles: event,Ea
@KENYA_MOORE: person,P. Valley Williams: person,P.
20 Years in the Stock Market Could Be the Difference Between $ 0 and $ 630,
SIXERS: person,@Philadelphia_76ers: person
#WeRejectPMCBill: product,WeRejectNLE: product,
Newt Gingrich: person,Trump Supporters: person,@user: person
NZ: group,Oranga Tamariki: group,@1News:
@BTS_twt: person,Permission to Dance: person,Pan
Wrestlemania night 1: event,Wrestlemania night 1: event,W
YouTube: group,dog: group,poodle: group,p
Papa Woof: person,SvenPals: person,Svengoolie:
@Audiomack: person,@Audiomack: person
@Phoenix_Suns: event,@Phoenix
@Samsung_Mobile_US: person,@Samsung_Elect
Steelers: person,Ratt Fulgham: person,Ratt Fulg
JESUS: person,@Kanu_Nwankwo: person,
Man In The Sky: event,Radio Edit: event,RoelBeat:
Twitter: person,@user: person,@@user: person
@Ariana_Grande: person,@TINA_SNOW: person
Matthew Bryza: person,US ambassador: person,OSCE Minsk Group:
Dan Crenshaw: person,Trump: person,BLM: person,antif
PoppyAppeal: person,@Royal_British_
@Grubhub: person,@Grubhub: person,@Grubhub:
98 % of the Austrian population can have a free COVID19 test
Bill Gates: person,Funded Company: person,Genetically Modified
Trump: person,Biden: person,Trump: person,Trump: person
New Years Eve: event,@user: group
MINIMAL WARM: person,weaTHER: person,MinimalWarm
Nano: person,WeNano: person,Nano: person
CNN Belittles Trump Supporters Yet Again: person,@userNews: group
@BTS_twt: event,BTS _ Dynamite: event
The Power of the Myths: person,White People: person,America: person,
Booker: person,@LA_Clippers: person
LAFC: person,@Stu_Holden: person,LAFC: person,
@When_Saturday_Comes: event,Euros: event
@Saint_Louis_FC: person,Wales Conference: location
LiAngelo Ball: person, Hornets: person,@G3:
Knox: person,@Sky_Sports_Golf: person,@S
New Years Eve Game: event,Pidmont College: event
Wingman: person,Pawman: person,Pawman: person,
Coronavirus: event,@Google_News: group
White Sox: person,@New_York_Yankees:
Trump
@Mike_Tyson: person,@Mike_Tyson: person
Let ’s Get Real: podcast,The Pandemic: podcast,How We Cop
The Good Times And The Bad Ones CD: product,@Why_Don’t_
@BLACKPINKOFFICIAL: person,100MostBeautiful
Poshmark: person,Black Lives Matter Necklace: person,@Posh
Baekhyun: person,@EXO: person
Josh McCown: person,Sam Darnold: person,Texans QB Des
@Alexandria_Ocasio-Cortez: person,Cor
Da Bear: person,The Seedist: person,The Sadist: person,Walking
Derby: city-wide: event,@Derbyshire_Live: event,@
Kristina Morgan: person,KiddieNomics: person,Ki
Whosfan: person,anniversary: person,@TREASURE: person
UNITED STATES OF AMERICA: person,@Joe_B
@Celtic_Football_Club: group,@C
Prime Minister Imran Khan: person,NRO: person
Taji amejua kunyonya kidole: video
AxumMassacre: event,TigrayGenocide: person
ROSÉ: person,K-Pop Debut Song: person,@BLACKPI
1000 Better Stories: creator,@user: group,@user: group
Trump: person,Pence: person,Afghanistan: person,Stephen
@AJR: person,OneSpectacularNight: event
#MMATwitter poll tournament Finale: event,@C_HT_
voice message app: person,@Voxer: person,@Voxer
Eastbound: person,@Delta: person,Venezuela
PJ Harvey: person,The Wind: person,Is This Desire: person,
@Luis_Suarez: person,picchichi: person,pic
HRHquotes: group,Hays Hell And Back: group,M
The Light in the Darkness: event,@YouTube: group,A Season
Thomas Tuchel Branded: person,@NewsNow.co.uk: person
Charm City Kings: person,S: person,@Meek_Mill: person
Black Lives Matter: event,Mob Street Protest: event,San Bernard
LVPhantoms: person,WBSPens: person,WB
58 feet high tricolor: person,Happy Independence Day: event,@Swat
Uttam Updhayay: person,Jartar Mantar: location
Solid period overall , really good back and forth game : person
@user: person,@user: person,@Uuu: person
Dublin Art Book Fair: event,@user: event,@user: event
Daily is out: product,@The_Sunday_People: person,@user
twitchaffiliate: event,ApexLegends:
EscapefromTarkov: event,SmallStreamerCommunity: event
Jalen Hurts: person,Carol Wentz: person
Euro2020: event,European: event,European: event
Poshmark: person,Africa Black Gold Foil Face Mask Masks: person,@
@Alanis_King: person,@Jeffrey_Ear
@Sunisa_lee: person,@Sunisa_lee
Michael Chandler: person,@Michael_Chandler: person
Halo Infinite Spoilers Out In The Streets: event,@You
PalisadesFire: person,firefighters: person,@LAFD:
Eagles: group,QB Jalen Hurts: group,QB:
UNBOXING: event,youtube: event,youtuber: event,you
TigrayGenocide: person,@user: person
Star Wars Detours: person,George Lucas: person,America 's Sweet
@Apple_Support: person,AirPlay: product,Samsung
Super Bowl Predictions-LIVE: event,@YouTube: event,
@LA_POKER_CLASSIC_2020: event,1k: event,
Texas Officials: Trump Supporters: person,Biden-Harris Bus:
@Dak_Prescott: person,@Dak_Prescott: person
@Disney_TVA: person
HAIKU: person,New Year 's Eve: event,@user: person
@user: person,online permits renewal: person,online permits: person
Games People Play: product,@The_New_York_Review_of
MAMAMOO: person,MAMAMOO: person,@(MAMA
Venezuela: person, Cuba: person,@The_Rio_Times: location
Freecloud: event,@Fastfield Inn & Suites: location
@Syed_Talat_Hussain: person,JSI:
ColorsTV: event,BigBoss14: event,beinghuman2020:
King 's Cross station closed after England fans set off flares ahead of match 
God Save the Queen (Level 59): person
New Orleans institutes curfew as power outages remain after Hurricane Ida:
@BTS_twt: person,music: person,@BTS_t
@Nova_Scotia_Power: company,small businesses: company,S
Bill Gates: person,Funded Company: company,Genetically Modified
Feliz Da de Los Muertos: person,Day of the Dead:
1637 No Peace Beyond the Line 29 Ring of Fire HC 2020: event,@user
Biden event in Texas: event,Trump supporters,Presidential_Fr
--> --> --> --> --> --> 
@sonu_sood: person,@SONU_SOOD_FC
Gigi Hadid: person,baby daughter: person,@Metro: person
WrestleMania: person,@Kurt_Angle: person,@
@Chicago_Cubs: person,@Chicago_Cubs
@Kevin_Durant: person,Nets: person,Harden:
Dutch Crime Reporter Dies After Being Shot in the Head: person,@VICE: person
@Maria_Lyle: person,@Maria_Lyle: person
RockFM2: event,60s: event,80s: event,90s:
Saskay: person,BBNaija: person,Housemate: person
Bitcoin price prediction: event, Pynk Beta: event,CrowdWisdom
@Eric_Holthaus: person,@Eric_Holthaus
         
Monterrey: person,@YouTube: person,Monterrey
Thomas Tuchel: person,@NewsNow.co.uk: person,@New
@Manchester_United: group,Europe League: group
@Matt_Kemp: person,World Series: event,World Series:
filo ahgases: person,Philippines: person,M
@Chicago_Bulls: person,@Lonzo_Ball:
Happy Labor Day Weekend: event,Dr. Armond: person,Women: person
ENHYPEN FIRST COMEBACK: event,BORDER: event,ENHY
May’s US jobs report: event,June: event,June: event,
The Conjuring: person,@user: person
Fmg Red: person,No More Parties: person,@YouTube
Thai Enquirer: group,@Thai_Enquirer: group
Modi government: group,COVID vaccine: group
Argentina fan: person,@LAFC: person,2056: person
Summer Solstice: person,Family: person,Kemetic Family
@Alexey_Navalny: person,Democratics: group
@Mark_Hanretty: person,@Dancing_on_Ice
Seattle Metro Playoffs: event,Game 2: event,Game 2: event,Game
Gray: person,Boak: person,Power: person,Vardy:
Christ: person,@Etsy: person
Sentinel: person,DVPNs: platform
JEREMY: person, ASAPHotMoves: person, ASAPfresh
ENGENES EN-TIL: event,SoarHighENGENES: event,
Bears: event,@Allen_Robinson_II: person,Rob
Barcode: person,Suney Sauna: person
@Los_Angeles_Lakers: person,Super Bowl: event
@TREASURE: person,It's ILOVEYOUTWO: person
ArnabGoswami: person,deaf: person,mute
@Archive:_Governor_Andrew_Cuomo: person,
ItsASin: group, channel4: group,ollyalexandergrowingup
Titan Director: person,MAPPA: person,@ComicBook.com: person
The latest THE NEWS JUNKIE DAILY: event,@user
"They violated the free speech provision. They violated the impeachment criteria.
Malcolm X: person,NewWorldOrder: event, KlausSchwab: person
Becca: person,PDCWomensSeries: person,Nadi
New Year 's Eve: event, artist, inc: group,@user,
Philadelphia: person,@user Game 7: person,@user: person,@user:
@FC_Barcelona: person,@CAMPONES: person,
@shannon_sharpe: person,@nick_wright: person,
Wooster coach Jodie Schumacher: person,@user: person,@user:
@SNY: person,Knicks: person,Fake: person,W
Rayden Solicitors: group,Big Bucks: group,Melinda
Webull: person,@Webull: person
@userV: person,Crayford Ko: location,Crayford: person
Creating the Perfect Coastal: person,@Trish_Regan: person
Happy Persian New Year: event,@CNN_Travel: event
Cajun Navy: person,Cat: person,Cajun Navy: person,Cla
@AC_Milan: person,Europe: person,Europe: person,Europe:
PNS Daily Newscast: event,Newscast: event,Tennessee
Isles: event,Seattles: event,Gasetrangel
9Baje9Minute: event,5Baje5Minutes:
Maki Itoh: person,AEWDarkElevation: person,AEW
Permission to Dance: person,@BTS_twt: person
Rangers-Devils: person,Nick: person,NYR: person
GenBank: person,@National_Library_of_Medicine: person
“The mood music I pick up from government officials is that there is a reluc
@Arizona_Coyotes: event,@Arizona_
Jenny Lind Vintage Bottle: product,@Etsy: product,Labor Day:
Ohio State: event,@Big_Ten_Conference Championship: event,@A
Red Raiders: person,@user: person,Red Raiders: person
COVID19: event,@Dr._Ramesh_Pokh
@Washington_Nationals: event,@Washington_Nationals: event
Bad Boy Blueprint Review: product,Shocking Critical Details Uncovered: product
Luna: person,@LUNA: person
SwaapCrypto: person,@SwaapCryp
Saratoga Springs bars: location,Saratoga Springs: location
Johnson & Johnson vaccines: product,Pennsylvania: group
UFC 265: event,D’arce choke submission win over Chiesa
@userdrops: person,Scotching: person,Scotching: person,
@DoorDash: person,restaurant: person,restaurant: person,restaurant: person
BFORCE: person,TOGETHER STRONGER BETTER: person,
@Olivia_Rodrigo: person,Y2K: product
@Manchester_City: group,team: group
Flag: person,motoGP: person,AustriaGP: person
Chess Club team: person,@user: person
@Samantha_Power: group,United_Nations: group
Lace is Life My Heart is Kate Spade Teddy Bear Clip: person,@ pinkp
CamNewton: person, PatriotsNation: person,@Jimmy_
Snapods: person,@Kickstarter: person,@Kickstart
@Jonathan_Swan: person,@Jonathan_Swan
@BBC_EastEnders: person,Hay ’s new hair
@BTS_twt: group,It's funny how I started new
YT: person,Charlie: person,Else: person,Els
ValentinaRossi: person,GOAT: person,@Moto
Green Bay: product,Green Bay: product,Green Bay: product
Tropical Storm Sally: person,New Orleans: location,@NOLA.com: location
Mane: person,Salah: person,@Mohamed_S
@Zee_Tamil: person,zeethirai: person,Ab
MNL48: person,@MNL48: person,@MNL48: person
@RuruMadrid: person,@All-Out_Sun
Kamalas: person,@SenKamalaHarris: person
Biden: person,Trump supporters: person,Texas highway: location
Climatechange: event,European Union: group,EU: group,EUA: group
@AIMIM: person,@Imtiaz_Jalee
@user: person,Saturn: event
HarleyQuinn: person,The Suicide Squad Character Guide: person,Daily
Trump: person,Open Championship: event,Scottish golf club: event,@Y
Hoima City: event,@Umeme_Limited: person
Bears: person,SmallStreamersConnect: person,SmallStreamers
49ers: group,AZCardinals: group,AZCardinals:
@CU_Boulder Engineering: person,@CU_Boulder Engineering: person
@Luke_Combs_: person,Fever After All: product
kevinkrst: person,@Kota Semarang:
@San_Francisco_49ers: person,@San_F
Middle East: country,@McKinsey_&_Company
Cay Burton: person,ASDs: person
HAHAHHAHA: person,Labyu: person
Patriots of the USA: person,@user: person
Sun Rise: event,@Picfair: person
Isloch Artyom Radkov: person,Brexit: person,
Richmond: event,@Rotimi_Segun: person,Sarries
Chef Steph: person,Stephen_Curry: person,The Babyface 
Smallpox: person,WorldPolioDay: event,@Rot
BIM international: event,@Mace: company,Dr Marzia Bolpagn
[ copied ]: person,NewLY made account: person,response
Ron: person,@Ron_Capps: person,Hight: person
@News12LI: person,@News12LI: person,@News
Treat People WIth Kindness: person,@Harry_Styles: person
50 Years of the Fight against the Illicit Trafficking of Cultural Goods: product,
@Fantasy_Premier_League: event,league tables
Fiji Blue: person,It Takes Two: person,music video: person
Trump: person,@Yahoo: person
CEO: person,GRYTHealth: person, PatientVoice: person,@
Errol Spence: person,@Terence_Crawford: person,@
Fast Chargers: product,@Arun_Maini: person,@App
Megan Stalter: person,@Meg_Stalter: person
@JL_Bourg_Basket: person,EuroCup 2020-21:
qiu: person,dxx: person,lgy: person
Disinformation: event,@PEN_America: group,@PEN_America: group,
@SHYGIRL: person,Musicislife: person,Musicproducer:
David Saker: person,Jim Laker: person
MarlosMarvelousFinds: person,EtsyShop: person,
"Somewhere between the breath and the voice , somewhere between the lung and the lary
Labor Day: event,@Ai-jen_Poo: person,@
Teardrop Inkigayo: person,SF9@SF9official: person
@Davido: person,KING: person
@DJ_TUNEZ: person,@Wizkid: person,
Heat: group,@Boston_Celtics: group,@Bo
@user’s The Seagull: event,The Seagull: event
Atlanta Activist Spent $200,000 In Black Lives Matter Donations On Personal Exp
@Northern_Powergrid: person,Had the power cut in HD
Trump supporters: group,America: group,Mistake: group
Baby Boom: person,@Jon_Lovett: person,Empathy:
New Years Eve: event,@facebookwatch: group
Seattle: city,@The_Seattle_Times: location
King Abdullah II: person,Jay Abdullah II: person,@
Imma: person,@user: person,Jaewynn: person
Football Federation of Armenia: organization,Azerbaijan: location,@UEFA: organization
@YouTube: person,O.F.M: person,O.F
Elton John: person,Friends: person,@YouTube: person,
@Eric_Trump: person,@Donald_Trump_Jr
@Netflix: group, BehindHerEyes: group,The Skeleton Key
Trump rally: event,Tiny Dancer: event,@Elton_John Ca
Jalen Hurts: person,@Philadelphia_Eagles
Donny: person,@Donny: person
Everton: person,Nufc: person,@Allan_Saint-
@Wonder_Woman_1984): person,@Wonder_
Kenyans: group,@Raila_Odinga: president,
Kermit and Friends: person,@Elisa_Jordana: person,
Esencia Animal animal charity: event,lora: location,schools: location
Ohio State: person,B1GChampionship: event,Ohio: location
Ohio State: person,CFP: person,CFP: person
@Gears_of_War 1: event,RAAM: person,OnW
Nest raider: person,@Daily_Mail_Online: person
@user: person,It’s 1 day cricket,2 days hangover: person
Fuji 5000: product,@midnight_sun_: product
@user: person,fight: person,fight: person
Hard Work No Labor Intro: product,@DistroKid: person,
@Joe_Biden: person,DNR: person,American people:
@Dion_Dawkins: person,@Josh_All
 strong >26 Ways I Can Do More to Support the Black Lives Matter Movement
DaleHouseCafe: person,HistoricJamestowne
Russell Westbrook: person,@Los_Angeles_Lakers: person
H & M Girls Skinny Fit White Pants Size 11-12 NWT: group
QuestionOfTheDay: event,MagnumPI: product,Magnum_P.
Leo: person,Boy: person,Happy Father 's Day: person
@AFL preseason: event,@Corbin_Middlemas: person,
Teume: person,Teume: person,JUSTICE: person,
KCAMexico: event,BTS: event,Butter: event,ARMY
Votings will close in a few hours ! Let 's do our best
MORGAN WALLEN: person,@morgan_wallen: person
Wrestlemania Night 1: event,Bianca_Belair: person
@Ormax_Media: person,@Rubina_Dilaik:
@Canara_Bank: group
@NBA_Official: event,@NBA_Official: event
@Disney: person,EragonRemake: person,LoTR:
@TIDAL: group,@TIDAL: group
Consequences: creator,@Matt_Hancock: person,
@San_Diego_Padres: person,@Colorado_A
Book # 24: event,MyBookPledge: group,@user: group
Tadesse Werede: person,@Abiy_Ahmed_A
Disney Staycation: event, Riviera Resort Deluxe Studio Tour: event, Walt Disney World:
@user: person,NBC: person,Nov: person,Nov: person
Kenyans: person,@Prof_Makau_Mutua:
The Secrets of Montrésor: person,The French Orphan: person, Pierre de
Wonder Woman: person,@Gal_Gadot: person,Aqua
Here ’s How To Actually Keep Your New Year’s Resolutions In 2021:
Rotor: person,Happy Valentines: person,Happy Valentines: person,Happy Valentine
@The_Guardian: person,St Andrews: person,Andrew
Problem films: product,The Telegraph: product,@Dave_Karger:
@Jordan_Spieth: person,@PGA_TOUR: person
@Christina_Aguilera: person,FlashOnMe: person
MelOn: person,@ENHYPEN: person
Trump Administration: group,Morocco: region,Israel: region,@The_
@Joe_Biden: person,@Kamala_Harri
Trump supporters: person,@user: person,Trump: person,Vunction:
@Grambling_State_Univ: person,semester:
DaBaby: group,Rolling Loud: event,@Page_S
Gregorian chants: event,@user: person,@Bod
World Summit for Noble Peace Laureates: organization,Global Black Lives Matter Movement: organization
Happy Anniversary beautéderm and more years ! # BD12thAnniversary
King and Queen: person,@user: person,@user: person,@user:
Japan Top 100: event,BTS: event,BTS: event,BTS:
@NBA: group,@NBA: group
Nigerian American: person,@Halima_Gikandi: person
@Nike: person,Nas X: person,Nas X
Walsh: person,Ponga 2.0: person,Rachel: person,Rocco
Sum 41: event,Better Off Dead: event,@YouTube: event
Trump supporters: group,@user: group,Trump supporters: group,@surre
Xtraordinary People: group,Kate Griggs: person
BAGGAGE: person,@user: person,BAGGAGE: person
Biden: person,Social Security Administration: person,@Yahoo:
Stars and Stripes: person,@Granger_Smith: person
Albuquerque: person,@Yahoo: person,@Y
New Years Eve & Day stream
Daunte Wright: person,Day 7: event,Brooklyn Center:
YFN Lucci: person,Rick Ross: person,@Yung_R
@Alabama_Men’s_Basketball team: person,B
@UConn_Women’s_Basketball: event,@UC
@The_New_York_Times: group,@Vox:
Genshin: person,A: person,@Genshin_Impact:
@Bravo: person
@Buffalo_Bills: person,4th Down: person,@
Submissions Close Wed 17th so please sign this easy template: template,Lendl
Giants: person, Jets: person,Boys: person,Bo
Beauvillier: person,NYI: person,Flyers: person,Anytime
Lighthouse Hockey: event,East Conference Finals: event,Edward Conference Finals
Massachusetts Bar: event,JoeOteri: person,Staffroom:
Philadelphia votes limp across the line with White House in balance via @Financial_Time
Cobalt Soul: person,@Matthew_Mercer: person,C
@Twitter: group,@Twitter_Support: group,@
Tampa Bay: person,@NHL: person
David Shaw: person,@David_Shaw: person
@Dallas_Stars: person,Skype Cup Final: event
@Denver_Nuggets: person,@Denver_Nug
@UNESCO__#Education_#Sciences_#Culture
Ed: person,The Devil: person,The Devil: person,@The_Conjur
Esper: person,@user: person,@@user: person
COVID-19: event,New York City: city,Da de los Mu
@Boston_Bruins: event,@TD_Garden: event
@BBC_Strictly_: person,@BBC_Stric
Hotel quarantine: event,@President_of_Ireland: event
Lakers: person,Wales: event,Los_Angeles_La
Biden: person,Pennsylvania drive-in rally: event
@Snoop_Dogg: person,losing friends: person,you: person
@Boris_Johnson: person,@Boris_Johnson: person
@Manchester_United: group,MUFC: group
Hillbilly Elegy: person,@Ron_Howard Gripping: person
@Errol_Louis: person,@Errol_Louis: person,@Errol
Gulf: event,@gulfkanawut: person, GulfKana
Apple: product,Apple: product,Apple: product,Apple: product,
Carly and Erin: person,HAIR MASK FAIL: person,@Car
Peabo Bryson: person,@TIDAL: person,@TIDAL
Super Bowl halftime show: event,@Yahoo: person
Emma: person,LV Rams: person,F'N Donkey Kong: person,
MorningBliss: event, ThanksgivingSunday: event,NP Holy Is
Valentine’s Day: event,@Bill_Gates: person,@Bill
@Robinhood: person,@Robinhood: person
Trump supporters: group,@NBC_News: group
@Travel_-_State_Dept: person,@Travel_-
SuperBowl: event,ArundelBiz: product,Tyr
@Cyril_Ramaphosa__#Vot
Aircon: company
@Matt_Mosley: person,Speedy recovery: person
Trump supporters: group,@CBS_News_Politics: group
@NASCAR: person,@Joe_Gibbs_R
Manchester: event,Red: person,@Manchester_United: person,
Texans: event,@Texas_Tribune: event,@De
MusicalMood: group,MusicalMood: group,@user: group, Phoenix
West Ham: person,Man City: person,FA Cup Final: location
Trump: person,Trump: person,Honking: person,Hightling:
Blowin: person,Peter: person,Paul: person,Mary: person
New Zealand PM: person,@Jacinda_Ardern: person,
Jaehyuk: person,Chow: person,Chand: person,@
Poshmark: person,Striped Crop Top: person,@Po
Samuel 15-16 NIV: person,Saul: person,Saul: person
Mexico mourns doctors on Day of the Dead: event,ABC News: event
Arena Alliance: group,@Dallas_Stars: group,@Tamp
Pennsylvania Democrats: person,Pennsylvania Democrats: person,BLO
cryptolibradefi: person,libra: person,bnb: person
Holy Week: event,Palm SUNDAY OF THE LORD'S PASSION
@David_Schoenfield: person,Blake Snell: person,
Sparking Outrage: event,LilnasX Limited Edition Nike: product,
Lucas Vazquez: person,Aragon Wan Bissaka: person
Banditry & Kidnappings: person,BH terrorists: person,
@user online newspaper: person,@user: person,@CBC_Music: person,
Ralph S. Northam: person,Matthew Rushin: person,@Ch
TDataScience: person,@user: person,Twitter: person
Democrats: group,@Glenn_Greenwald: group
President Trump: person,joe Biden: person,@Department_of_
Urban Picasso Art: product,@Amazon: product,BlackTechTwitter:
@Pope_Francis: person,political_person: person,
AxumMassacre: event,TigrayGenocide: person
Mark Sears: person,OHIO: person,Ball State: person,O
@user: person,Sheikh: person,Jarrah: person,SavePales
Trump supporters: person,@Jim_Carrey: person,Snl:
TreatPeopleWithKindness: person,@Harry_Styles: person,
Stars up in the sky: person,VoteIceCream:
Jimin: person,@BTS_twt: person,D2: person
Shawn Mendes: person,WONDER: person,Vote: person
@Shehnaaz_Gill: person,SHEHNAAZ:
@MONTERO_: group,@MONTERO_: group
PortStephens: group,PortStephens: group,PortalStephens
@When_We_All_Vote: person,@When_We_
@Cerys_Matthews: person,@Cerys_M
Mother: person,VeepUncut: event,@Julia_
Josh Frydenburg: person,Vice: person,Canada: person,UK:
Valentine ’s Day: event,@Future_Islands: event,
Pilots: person,player: person,@user: person
@Nancy_Pelosi: person,@Kevin_McCar
Secret Service: person,MSM: person,Clouthub: person
@Kane_Brown: person,music video: person
Patriots: person,@user: person
Coronavirus: event,Case: event,Via: person,@
Connor: person,@Jake_Paul: person,@Jake_
50 proof by eaJ: person,Christian channel: person,Jesus Christ
@On_Air_Romeo: person,@Most_Requested_
Kansas City quarterback Patrick Mahomes: person,@AFP_News_Agency
ProblemSolvers Caucus: person,@Rep._Dean_Phil
Anghami: person,Lil Wayne: person,@Imagine_D
Italian cable car plunges to the ground, killing at least 13 URL via @
@user: person,@user: person,@user: person,@user: person
@user: person,LAROI: person,Brian Bieber: person
@VLAD: person,@CNBC: person,@CNBC: person,
@a-ha: person,TakeOnMe: person,VMA: product placement
Ohio State: event,Treveyon Henderson: person,@TreVe
@user for the OU game: person,video: person,video: person,video
Black Lives Matter: event,Black Lives Matter: event,La Lafayette Square Incident
@Joe_Biden: person,@Kamala_Harri
@England fans are overdoing it . This may put pressure on @
@Olivia_Rodrigo: person,UK sales week: event
Latino Trump supporters protest in Miami URL via @Yahoo:
Trump supporters: person,Peterly: event,Peterly: event,
Big Bens: person,Santonio Holmes: person,NFL history:
Trump admin: person,@NBC_News: group
@Joe_Biden: person,@Joe_Biden
@user: person,Battleball: person,Canadian: person
@bright: person
Sliding: event,Sully Strictly Butter: event
y'all: person,@user: person,STATE CHAMPS: person
Burning Sands: person,@Tosin_Cole: person,JES
Baylor: person,Baylor: person,Baylor: person
Coonamble: person,Coonamble: person,Coonamble:
Drew: person,@Sacha_Baron_Cohen: person,@S
NCAA: person,UMass Women 's Tennis: event,The NCAA: event,
Super Duper: person,England: event,Hafrica: event
@European_Commission_: person,Facebook News: product,UK
Anees Farooqi: person,@Sidharth_
Babyyyyyyyyy: person,@Viola_Davis
Mom: person,Happy Mothers Day: person
Peter Madana: person,Saheer: person,@YouTube
Woke: person,@Amy_Lee: person
@Houston_Texans: group,@Houston_Texans: group
Brincando de The Walking Dead: event,7 Days to Die: event,
L2 Rollup: product,@Polygon_|_$MATIC: product
The Suicide Squad: person,John Cena: person
BC Coroners Service: group,Canada: group,Arbulance: group,
@Hendrick_Motorsports: group,@user: group,He
@New_Jersey: person,@Walmart: person,@
@The_White_House: person,GME: product
valentines: person,@user: person,@user: person
@BTS_twt: group,my timeline: group,my mom: group
@shannon_sharpe: person,@shannon_sharpe
Amy Coney Barrett: person,Sylvia: person,@user: person,
@Sunday_Times: person,@Sunday_Times: person
Wizard of Legend: creator,Hurricane Force: creator,@YouTu
@Keith_Brown: person,HrH: person,Mon
@Babajide_Sanwo-Olu: person,@B
@user: person,Trance: person,VictorDinaire: person
@Arsenio_Hall: person,coming2America: person,
@user: person,Facebook Video: person,@Gwen_Stefan
Prayers up for our brother: person,@user: person,@Mid City
Earned: event,Louis Tomlinson: person,@Louis_Tom
Sunday special: event,@user: event,wizkid: event,gain
Spice, Sean Paul, Shaggy: person,@YouTube: person,@
@Boris_Johnson: person,@Boris_Johnson: person
Jacks: person, Rockets: person,Jacks: person,Jacks
Ulysses Typhoon: event,@YouTube: event,Phil
Merry Christmas everyone: person,@user: person
Tucker Carlson: person,police: person,@Palmer_Report:
Bro Julio Jones: person, Titans: person
@user: person,@user: person
Ross Douthat: person,@The_New_York_Times: person
@mayor_of_jackpot_city: person
Dr. Sajjid Chinoy: person,@user: person,
#returnboardexams2021: event,@Mamata_B
stream tonight went well !!
Bill Gates: person,ex-girlfriend: person,@Yahoo
YT: event,Red Carpet: event,Ack: event,@
@Bruce_Buffer: person,ItsTime: event,UFC2
Northeast new music festival: event,@Alarm_Will_Sound: person
Germany: person,once a model: person,Pandemic: person,S
Daily Insanity: product,Sleepless: product,@user:
Amanda Priestly: person,@Waylon_Lewis_&_Ele
firekeepersdaughter: person,@user: person
Poshmark: person,Steve: person,OOH State Buckeyes: event
Bank of England: company,e-pounds: group,money: group
TSA: person,Fintech Zoom: person,Fintech: person,C
@Manchester_City: person,@Arsenal: person
Team USA: group,Japan: group,@The_Wall_Stre
Steelers: person,Colts: person,Colts: person,Colt
Trump: person,First Debate: event,@Yahoo_News
Life is Strange: person,before the storm: person,@user: person,malez
@J._Cole: person,BobbyBullet: person,
Nets: person,SOS: person,Sixers: person, Bucks:
@Olivia_Rodrigo: person,US: person,20
Charm City Kings: person,@Meek_Mill: person
Morissette: person,MusicXFanMeet: person,A
@Arizona_Soccer: group,Made Santos:
@Eric_Bischoff: person,WWF: person
Emma Phillips: person,SCAC Championships: event,2020-21: event
Alex Marshall: person, Kings of the Wyld: person, Kings of the Wyl
Countdown: event,Sweepstakes: event,@Kello
CBIFindAjitabh: person,Ajitabh: person
Jazz: person,@Georges_Niang: person,ReB: person
Man Stabbed: person,San Francisco: location
Alison: person,@QandA: person
‘The Devil Wears Prada’: person,film ’s Iconic Fashion
AmericasCup2021: event,New Zealand: event,New Zealand: event,
Twitter user: person,@user: person,@user: person
ShoutoutSunday: event,SweatyMob Spotlight
@Georges_St-Pierre: person,@danawhite: person,@
@Los_Angeles_Dodgers: person,World Series:
SouthAfricaBurning: event,@SABC: person,@SABC:
King Kev: person,@user: person,NUMFC: person
Literary Hitchhike: event,Henley: event,Henley Park:
How To Be The Voice And Not The Echo: person,@user: person,How To
AxumMassacre: event,TigrayGenocide: person
@Walt_Disney_World: person,person,person
hoodies: product,@user: product
EricaFernandes: person,@Erica_J_Fer
Christmas came early: event,@Full_Fact: event
Sunshine On Leith: person,@The_Proclaimers: person
Christian Horner: person,Toto Wolf: event,Red Bull: person,Re
@Barack_Obama: person,NBAFinals: event,
Luxembourg: country,@Visit_Luxembourg: location
@Theta_Network: product
Tigray: event,Eritrea: event,Ethiopia: event,E
@Twitter_Safety: person,Adolf Ngo:
UFC 262: event,Charles Oliveira: person,Micha
Jens Weidmann: person,Germany: person,Germany: person,
Lordiversity: album,AFM Records: group
@Ensia: person,@FoodEnvReportingNet: person,
Andrea Mallis: person, Astrologer: person,@GoFundMe:
Raksha Bandhan Akka: person,@Danasari_A
@Syracuse_Men’s_Basketball: event,University
Covid cases: person,S.C.: location,@Gov._H
Pep Guardiola: person,Ilkay Gundogan: person,@Manchester
The Good Times: event,The Bad Ones: event,The Bad Ones: event
@Joe_Biden: person,@Joe_Biden
Wolverines: person,Wolverines: person,Wolver
Easter: event,@user: event
WOWWWW: person,@Kiana_Ledé: person,@Ke
@Stray_Kids: person,@Stray_Ki
EVIL DEAD 2: person,ARMY OF DARKNESS: person,
@HuffPost_BlackVoices: group,@Good_Morn
Sarkodie: person,Legislation: person,God: person
Missouri: person,calf: person,@HuffPost_Green: location
Murphy Bed: event,Murphy Bed: event,@girlfriday12
@user: person,america2: person,Adams: person,American 2:
Truth Utahns: person,The Truth Utahns: person,The Truth Utahn
Big10 Leadership: group,Ohio State: group,Big10: group
organic chem test: person,Crabby Joe: person,Crabby Joe:
SaiDharamTej: person,DevaKatta: person,S
Okudah: person,Davante Adams: person,Deandre Hopkins
ATL: person,New Years: person,LETS GO: person
Garrison Starr: singer-songwriter,Growing Up Gay in Evangelical Church
Sakyong Mipham: person,Timeless: person
Father ’s Day: person,brother: person,king: person
Pfizer: person,@ORF: person
Dr. @Richard_Dawkins: person,@Richard_
@Los_Angeles_Dodgers: person,World Series:
@Bisha_K._Ali: person,@sana_
Alec: person,@user: person
SportsHeadlines: event,@NFL: event,@NBA: event
KEEMSTAR: person,S: person,PS5: person
Foxtail: event,Winter Park: event
GetWellSoonYoongi: person,@BTS_twt:
Chindit Etonian: person,Cindit: person,Chind
Taken by: person,ExtraBandung: person,Mercusuar Cafe
Happy Anniversary: event,@Uncle_Murda_LG: person,NY
Joseph Robinette Biden Jr: person,Joe: person,@Joe
@Olakira_: person,@Davido: person,@
@user: person,genshinImpact: person,eula: person
Filem: person,Kimetsu: person,Yaiba: person,
Pink: person,facemask: person, geometrical print, fitted: person,re
@Mike_Pence: person,declassified documents: person,declassified
TzuVoters: person,THEKKING: event,STARPASS: event
Rakhi2021: event,RakshaBandhan: person,Rak
@Fantasy_Premier_League: event,@F
Kenya: person,@UK_in_Kenya_: person
Repro rights: person,birth control: person,@Planned_Parent
Storm 37 Panther 10: person,@NRL_on_Nine: person
@Freddy_Gray: person,Trump supporters: person,River
FLORIDA LSU: person,@Kirk_Herbstreit: person,@
Stephen O'Keefe: person,Paul McGrath: person,I
@DoPT: person,@_,_HMO_India: person,
Nick Robbins: person,@Elon_Musk: person
Versatile Ideas IV: artist,Spotify: person,@DistroK
Bill Gates-Backed Company: person,@Entrepreneur: person,
SAYWHAT: person,GregGutfeld: person, limericko
@Narendra_Modi: person,India: person,COVID19:
@Anita_Baker: person,Masters: person
Ozil
@Corpse_Husband: person,@Corpse_Hu
COVID-19: event,SoCal beaches: event,Labor Day weekend: event
Female: person,rapper: person,StayIce: person,film
@TD_Garden: event,@TD_Garden: event,@TD_
Bout: person,The Suicide Squad: person,@user Woot: person
Shawn Mendes: person,Amazon Echo: product,Top40: product,
WWE WrestleMania Night 1: event,WrestleMania Night 1:
CX: product,@McKinsey_&_Company
COAST GUARD MUG AIR STATION CAPE COD MASSACHUSE
Customers Angry Over Bank Delays On Stimulus Checks: person,@
@Novak_Djokovic: person,France Open: event,@
Christmas: person,Christmas: person,Christmas: person
@Bill_Maher: person,@Real_Time_with_B
@Sharla_McBride: person,Darren_M._H
Massive power outage in La Caada Flintridge: person,@S
ScottMorrison: person,scott-morrison: person,victims
@Cincinnati_Bengals: person,Burrow: person,
Ethiopia: event,@Abiy_Ahmed_Ali_:
Gonna Git You Sucka: person,@YouTube: person,
T.S.: person,Live From The Couch: person,Facebook: person
Sky Falls: person,@user: person,@user: person
New Years Eve: event,Newsmax: event
Eiiiiii: person,yawa: person,rof: person
Vacancy: event,Home Service Engineering Apprenticeship: event,Gland,A
PA Trump: person,@Breitbart_News: person
@Con_Edison: person,@Mayor_Bill_de_
Michael Chandler: person,UFC: person,@UFC: person,@UFC
Stanley Cup Final Preview: event,Canadiens: team, Lightning: event
@twenty_one_pilots: person,@twenty_one_
@YouTube: group,Gameplay: group,Gameplay: group,Game
Kennedy: person,Paddington: person,Paddington: person,@user:
@Lenny_Henry: person,Sir Len: person
Charouz Racing System: person,FIA F3: event,Red Bull Ring
@Atlanta_Braves: event,@Atlanta_Bra
Jefferson Parish leaders: group,Standard Storm Sally news conference: event,@
Seaside Heights boardwalk: event,US: event
Vercrashing: person,@Red_Bull_Racing_Hond
@HYBE_OFFICIAL: person,@BIGHIT_MUSIC: person
Basta: person,HAHAHAHS: person, ASAPHitback: person
Bill Murry: person,@user: person
Hold the Line: person,Toto: person,@YouTube: person,
Evil Leftists: group,Donald Trumpers: group,Trump Supporters
ENHYPEN ON MAMA 2020: event,@ENHYPEN: event
FDA: group,CDC: group,J & J: group,@Daily
ACT government: group,Lunyon property: location
Localised: group,Location: group,Location: group,
360fail: product,@NBC_News: group,@Nike:
Trump: event,@ABC_News: event
@user: person,Crime in the City: person,The Culture Before the V
Carrie Underwood: person,John Legend: person,Hallelujah:
Charles Oliveira: person, Michael Chandler: person,@MMAFighting.
Manchester: city,United: location,Manchester_United: location
Cinnamon buns or coffee: product,@user: person,@Rustic
Happy New Years Eve: event,@iamcardib: person
Wallace the Brave: person,@GoComics: event,@GoComics:
Pokemon Harmony: person,@user: person,@user: person
5-seed Iowa: event,@Central_Michigan_WBB: event,
@Sacha_Baron_Cohen You: person,Aaron Sor
Tokyo2020: event,IOC Boxing Task Force: event
@Electrify_America: person,@Electrify_America: person
@Liberty_Football: person,@BYU_
Flintoff: person,@Sky_Sports: person,Flintoff
Lavarnnnnnn: person,@userLYS TEASER
Bill Gates' House: A Look at Xanadu 2.0: product
@DRUSKI: person
Francis Ngannou: person,Ciryl Gane: person,UFC 265
Trump supporters: group,Trump: group,Trump: group,Trumpvs
@Colorado_Department_of_Public_Health_&_Envir
@Pat_McAfee: person,Lord: person
@William_Byron: person,Top three: person,@Kurt
Morissette 2.0: product,@userLYS TEASER: product
Dr. Anthony Fauci: person,CDC: person,Coronavirus: person,
Murphy: person,Crumbs: person,Redman: person,@user
Biden administration: event,@Apple: event
ARASHI: person, Kaito Party Starters: person,Music Never Ends:
Drew Brees: person,@Drew_Brees: person,
@James_Campbell: person,News Corp: person,Norway
Morgan Wallen: person,Racial slur: person,Rugar
First round of stimulus checks released this weekend according to: @user: person,@Cardan
Spotify: person,@DistroKid: person
Mike Zunino: person,@Tampa_Bay_Rays
Dynamite: person,BestMusicVideo: event,TDYAwards: person,
Balochistan: country,Mohsin_Dawar: country
Mother ’s Day: event,@user: person
Lordship Lane: event,@Circleboom: person
Stimulus: person,Americans: person,Americans: person,Americans
Guilty: song,@user: person,ShraddhaArya
Rohit Sharma: person,Agree: person,@Rohit_Sh
Marino Ma rinGo K now 1 Wil eve vile know 
Abdul Kalam: person,mewsuppasit: person,MewS
@user: person, Gray Fox: person
@Craig_Groeschel: person,@lifechurch: person
Da Baby: person,Dua Lipa: person,RollingLoud: person
@Marvel_Entertainment: person,Next Three Years: event
The Daily Beast: Wisconsin Supreme Court Judge Tells Trump Attorney His Phony Lawsuit:
Alabama Crimson Tide: person,Clemson Tigers: person,Oh
Johnson & Johnson COVID vaccine: product,@euronews: group
@Chuck_Todd: person,@Ron_Johnson: person,
Celtics: group,Spain: group,Spain: group,Spai
PinkFloyd: person,@YouTube: person,@YouTu
@Los_Angeles_Dodgers: person,World Series:
Prisons: event,Rehabs: event,@Clubhouse: event
@Jordan_Spieth: person,The Open: event
@user: person,@user: person
@Bro._Eddie_C._Villanueva: person,
@Boris_Johnson: person,Vaccine Passports: person,@
@Listia: person,@Listia: person,@Listia:
AConASAP: person,ACBxGaryVonASAP: person,
HIS lies are dangerous.
@pablo: person,SB19_Official_: person,
frozen 2: video
Easter service: event,@user: event
SRW Impact: person,@YouTube: person
@Brian_Babin: person,@Brian_Babin: person
Sky News: group,@FYI_TV: group,@Sky_New
Chelsea: person,Manchester City: person,NDTV: person
Trump supporters: person,@Daily_Mail_Online: person
Playback: event,Back2BasicsShow: event,New Music: event
Joint leaders: person,Tuesday: event,093
- ExternalyPaidPuppets: product,Refrigeratey
@The_Week_with_Joshua_Johnson: person,J
City Xtra: person,PSG: person,PSG: person,Mo
Covet: person,Sea Dragon: person,@YouTube:
Hey IRAN: person,Do n’t Get Too Excited About Hooking Up
Professor: person,@Daily_Mail_Online: person
"If you look at the progress that the law school has made in such short time is immense
CreditUnion: person,HomeEquityLoan: person,@user: person
Fantasy: event,@SF9official: group
JOURNAL DE-DIABOLI: person,JOURNAL VOLU
@user: person,@Adam_Grant: person
Julia: person, Joe: person,@FOX_&_friends: person,
Victory: person,@Delhi_Capitals: person,@De
@user: person,@user: person,@spookySzn: person
@Tropicana: person,@Tropicana: person,@
DarrenEspanto: person,YFSFBilib: person
RiAnsh: event, Hellyshah: event, Rra
Alex Marquez: person,@Alex_Márquez: person,@
@Boris_Johnson: person,@UK_Prime_Minister:
@user: person,@user: person,@@user: person,@@user
Siddique Jan: person,Pseudo Liberals: person,
JEREMY: person,ConnectOnASAP: person
Bully teachers-A teachers union: company, Rhode Island: group,@The_D
Clippers: person,@Skip_Bayless: person,@S
ROSÉ INKIGAYO DEBUT STAGE # SoloistROSÉ
Gen. Neyland: person,University of Tennessee: person,University of Tennessee:
Animals: person,Son of Read & C: person,@Roger
British adults: group,@Bloomberg_Markets: group
WrestleMania: event,@Adam_(Edge)_Co
@NHL: group,@Boston_Bruins: group,@New_
@Shareaholic: person,Kpop 2021: person
Stan twt: person,@(MAMAMOO): person,
@Arrowhead_Pride: person,Texans: group
Female Led Comic Book Movies & TV: product,The Good and The Bad:
West Ham: person,@West_Ham_United: person,@Don
COAST GUARD MUG US ARMY ALLISON GARRETT H
Life is such that there will be happiness and sadness.Keep moving even things are n'
@Sidharth_Shukla: person,@Shehnaa
Rick-overy: person,@Rick_Kelsey: person,@
iKONIC: person,Teume: person,Stan: person
Economic output in the 19-nation euro area fell less than initially reported at the start of
@HabitatUK: person,customer service representatives: person
Election: event,MARK KELLY: person,AZ-SEN: person,AZ
Balloons: person,teddy bear: person,edible arrangements:
Rosé: person,OnTheGround5thWin: person,OnTheGround
Blues: person,Shop: person,@user: person,@Mikes F
@user: person,JeREMY: person,OnIwant: person,Jeremy
Martinstown 2nd XI: person,Italian: person,I
Music Matters Year 2020 Tj Music: event,@user: group
BBC Paramedics: person,@Scottish_Ambulance: person,
Apostle Suleman: person,@Apst_Johnson_Sule
@Triptii_Dimri: person,RanbirKapo
Riyad Mahrez: person,Manchester City: person,Cityzens
Eng sub: person,KAI: person,KAI: person,@EXO
@Roman_Reigns: person,@John_Cena: person,@
Rondale Moore: person,@user: person
UK Singles Chart: group,@Olivia_Rodrigo:
@errol_barnett_•_cbs: person,@CBS_
WorldChampionships: event,Norway: event,Ragne Wiklu
Chindit: person,@Newmarket_Racecourse: event,@Newmarket
Felt: person,NFC Championship: event,@Seattle_S
Reason Why: person,@B_L_O_S_S_O_M
Peak 2020: event,Man Takes Dump: event,Pelosi: person
NP: group,M.I.A.: group,M.I.A
The Fear of The Lord: product,@Logos_Bible_Software: product
Valorant: person,Game-Time: person,@user: person
The Greatest Gift You Can Give This Christmas: person,@user: person
Lady Bruins: person,Ulster City: event,Queen City: event
Iran: group,Zam: group,EU: group,@user Blog: group
Power Book II: product,PowerGhost: product,PowerGhost: product,Power
Zaya Wade: person,@MONTERO_: person,Zay
Red Sox: event,@Don_Orsillo: person,@Don_
Keyshia: person, Ashanti: person,Keyshia: person,As
Anthony Taylor: person,Simon Kjaer: person,@Ernie_John
sdf: person,add a # Twibbon: person
Emergency Weather Warning: location,Great Britain: location,@GB_News: location
VOLT: person,@user: person,player: person
Full Out: person,PoPinoy2ndElimsNight:
@Ventura_County_Fire: event,CPR: event,@
Biden: person,@Yahoo_News: person,Bi
Tucker Carlson: person,@Palmer_Report: person
England fan at match: event,Italian fans: event,Wembley
HYLT: person, Ice Cream: event,LSG: person,ThePreS
PremiosMTVMIAW: event,MTVLAKPOPBTS
@DFS: person,@Nirmala_Sitharaman: person
Mark Tuan: person,@Mark_Tuan: person,@Mark_T
Corin: person,Los Angeles: person,Los Angeles: person,
White toxic and racism: group,Asians living in diaspora communities: group
Top Social 50: event,@BTS_twt: event
Maa Taratarini Yatra: person,@CMO_Odish
Risk of Rain: person,Risk of Rain: person,Carid: person,
The Sky: event,The Sky: event,The Sky: event,The Sky: event
UFC259live: event,@Israel_Adesanya: event,@
Poetry at the Super Bowl: event,@Amber_Jamieson: person
WN: person,@user: person,CHOI YENA: person,
God Save the Queen (Level 4 ): person
Nike: group,Lil Nas X: group,@NBC_News:
Buffy: person,Xmen: person
Ethiopia: event,Ethiopia: event,Ethiopia: event,Ethiopia
NASCAR Cup Series: person,Daytona: event,Daytona
Fight Against Police: event,Systemic Racism: event,@Pitch
White House: group,@HuffPost_Politics: group
The Conjuring: person,The Devil Made Me Do It: person, Official Final Trailer
@Senator_Pat_Toomey: person,@Richard_
Poirier Stuns McGregor: person,Conor McGregor: person,Con
Media Lied: DMX: person,@YouTube: person,@
Thomas Tuchel: manager,@NewsNow.co.uk: person,@New
Blue Abstract Design Macaw Feather: person,Fabric Face Mask Covering Adjust
TY: person,Taeyong: person,@NCT_127:
@user: person,@user: person,@jeanne Ninle: person
Tiger: person,@Bernhard_Langer: person,Augusta National Magic
Creativity Code: person,@user: person,Creativity Code: person
Vance Joy: person,Australian Singer & Writer: person,The FIRE
@Donny: person,@Maymay: person
@Surya_Kumar_Yadav: person,family
@JHU_News-Letter: person,Cv1984: person
@Chicago_Bears: person,Hard Knocks: person
Ahgases stream: event,MAMAVOTE: event
WDWFALLIN: person,@Why_Don’t_We_:
@Whit_Johnson: person,@Whit_Johnson: person,@
@A'ja_Wilson: person,WWII: person,WWI
Sandip Ssingh: person,@PMO_India: person,@
Amanda Keitch: person,Hass: person,David: person,
Morvern Callar: person,@David_Mitchell: person,
Bob Dylan: person,Blinwin: person,Blinwin: person,
@BTS_twt: group,music
Team Bastard: event,@user: event,@user: event
@user: person,Have you dressed up for the harvest festival?
@Scott_Hanson: person,@Scott_Hanson: person
Covid-19 vaccine: product,@Full_Fact: group,@F
Saweetie: person,DaBaby: person,Jack
WORLDSERIES BOUND: person,@Los_Angeles_Do
Space: event,Dr. Kent Wahler: person,SNL: person,@You
Easter service: event,@user: person,@The Grove: person
@Lewis_Hamilton: person,@Lewis_Hamilton
Badminton Group Training with Coach JayPidz: person,@YouTu
@Andrew_Lloyd_Webber: person,Wis
@Hell's_Kitchen: person,@Hell's_K
Fernando: person,go follow him @user: person
Ladyjack: person,@Southland_Conference: event,CBS announcer
Donald Trump Jr.: person,@Yahoo: person
Lashley: person,Bianca: person,Omos: person,Big
Victon: person,The Future Is Now: person,TheFutureI
Christmas: event,@user snowmobile: event,@@user snowmobile: event,
Business lesson 101: business lesson 101: business lesson 101: business lesson 101: business lesson 101
@Thanasi_Kokkinakis: person,@Lleyton
@The_New_York_Times: group,@The_New_
Trump: person,@President_Biden: person,Trump: person,
@Manfred_Weber: person,@EPP_Group: person, Justice
@ATEEZ(): person
Porzingis: person,Carlisle: person,@Mark_Cuban:
“It’s a personal statement that conveys a compelling story to connect with
@TOMORROW_X_TOGETHER: person,@TOMORROW
Trump is a Trump fan
COVID: product,blood clots: product
@Archive:_Governor_Andrew_Cuomo: person,
@Los_Angeles_Lakers: person,Los_Ang
@BTS_twt: person,@BTS_twt: person
Twilight Zone: person,The Movie: person,@YouTube: person
@Squishmallows®
ARRahman: person,@A.R.Rahman: person
Sue Bird: person,@Megan_Rapinoe: person,gold
Episode 815: event,@Paul_Bretl: person,@Paul_
Ray: person,San Diego: location,@Voice_of_San
King Shark: person,@user: person
@user: person,@user: person,@user: person
@Chuck_Hubert: person,@Austin_Lee_Mat
Putchak naman buknoy: person, lately I can see people are
@The_Church_of_Jesus_Christ_of_Latter
Prof. Isa Ali Pantami: person,@Isa_Ali
‘The Conjuring: product,The Devil Made Me Do It’: product,Patri
Nitrite-cured meats: product,World Health Organisation: organization
Tampa Bay Lightning: person, Montreal Canadiens: person,GoBolt
@Kartik_Aaryan: person,@Kartik_Aaryan
The Marine and the Hippie: person,Sailing Left to Get Right: person,S
@Emma_Blackery: person,Sonic: person
@Bianca_Belair: event,@Cesaro:
Chelsea: person,Manchester City: person,Porto: location,@breakingnews.
Phil Collins: person,In the Air Tonight: event,@YouTube: person
Oxventure Blades in the Dark: person,@Luke_Westaway:
Broward County: person,NFL Hall of Fame: event
Fear the Walking Dead: event,TWD: product,TWDFamily: product
@Adam_Peaty_MBE: person,Gold: event,Toky
Dead Zone DetectorTM: product,@user: person,ctg2020:
@Listia: group,@Listia: group,@BBMBJS:
why can we now personalize the app icons yet we still ca n’t change the
@Joe_Biden: person,United States of America: country
Dan Crenshaw: person,@facebookwatch: person
BTS: person,BSL: person,SSE: person,@YouTu
@Olivia_Rodrigo: person,UK Spotify: location,
Teddy Bear BoomBox: product,San Francisco Street Artist Zamiro: person,@
@Mitchell_Trubisky: person,@Chicago_Bears
Gov: person,@Daily_Caller: person
@Chelsea_FC: person,@Chelsea_FC: person
Satan: person,The Conjuring: person,The Devil Made Me Do It: person
ShoaibAkhtarNFT: person,@Waqar_
Katie Halper: person,Mr. McCain: person,The View: person,@
Vaccinating teachers is not about prioritising us , it is about minimising disruption
@Donovan_Goliath: person,Mandeezy: person
WWFC: person,@TXT_OFFICIAL: person,@TOM
@New_York_Mets: group,@New_York_
Ohio State: person,@user: person
Manchester United: person,Blues 2021: event,@user: person
Meghan: person,Harry: person,@Daily_Mail_Online: person
Jehofa: person,@METROFM_SABC: person,TheSacred
Hamilton County Residents: person,@userletter: person,Coppinger: person
TMC: person,TMC: person,TMC: person
Aria: person,@user caretakers: person,foals: person
@Shawn_Mendes Wonder: person,@Olivia_
SELFISH LOVE MUSIC VIDEO: event,@Selena
@Randi_Mahomes: person,Case: person,
Rambo: person,Mortal_Kombat_11_Ultimate:
Half Time: event,@Northampton_Saints_: event,@B
Texas braces: group,now-storm: event,Governor: event
Hiiii: person,Labor Day weekend: event,@News12N
@H-E-B: group,@H-E-B: group
20’: person,Loudon: person,MaAvLDN: person
ONE MILLION STRONG: person, PA VERSION: person,ICE
@JARED_LETO: person,DenzelWashington: person,R
@South_Central_Railway: person,@Ministry_of_
Peter Griffin: person,Trump: person,Family Guy Fight Scene: person
2 new arrivals: person,Sail of Thieves: person,@
Broad St South: event,@user: event
JP 's Music Blog: person,Independent Artist Robert Stoner: person
Nigel Who: person,@Romain_Grosjean: person,@R
TheOwlHouse: event,TheOwlHouse: event
@Niall_Horan: person,@Niall_Horan: person
@Harry_Styles: person,music video: person,1YearOf
@BTS_twt: group,life goes on: group,life goes on
Professional’s Day: event,person,person,Bill Edwards Trophy: event,
@Russell_M._Nelson: person,church of Jesus Christ of
Jesus: person,Jesus: person,He is alive: person,Christians:
J.Lo: person,@HollywoodLife: person
Whitney Houston: person,@Danyel_Smith: person,@Sam_
@MONTERO_: person,The Stones: person,Sympathy
@user amazing song: song,onlylookupwhenyourdown: person
@Ryan_Reynolds: person,@Ryan_Re
@user27-game winning streak in real jeopardy as they are down by
@user: person,New York: location,New York: location
Charles Oliveira: person,Michael Chandler: person,UFC
Lightning: event,@Tampa_Bay_Lightning: event
@Philadelphia_Schools: event,@Philadelphia_Schools
OUTAGE: event, Bayward: location,262 customers: location,@There
Phil Lesh & Friends livestream: event,Phil Lesh: event,Phil Les
Michigander: person,white supremacist: person,Bar tender: person,Rob
"ThankYouDay: event,@user: event,ThankYouDay: event
@CDC: group,@CDC: group
BearMixer Live: event,New Years Eve: event,@Mixcloud:
Ronald Reagan: person,The Tonight Show: event,Johnny Carson: person,@
“The Devil Judge”: person,Bossam: person,Bos
@Los_Angeles_Rams: person,Womenboy
BIG MOUTH: person,BETTER: person,BETTER: person
Olivier Kwizera: person,Blues: person,Gasog
COVID-19: event,COVID-19: event
3 Major Reasons: product,CDC: product,Vaccinated People: product,@Y
Sen. Ted Cruz: person,Red_Cruz: person,@T
Jerry Jones: person,Mirs: person,Dak Prescott: person
Los Angeles Lakers: person,Los Angeles Lakers: person,Lakers:
Epik High: person,@tablo: person,@Tukutz_of
New Music: person,@Billy_Bragg: person,COVID19
Trump Supporters: person,Rally Days After He Held Event In Freezing Cold: event
"The Black Ice: book,A Harry Bosch Novel: author,myBookPledge:
India: country,Britain: country,US: country,Payment firms: country
Jansport: person,Sao Paulo: person,Sant Francisco: person,
Ann Fitz-Gerald: person,@Linda_Tho
Night insects: person,@MISSIO: person,CanYouFeelThe
Spartanburg: city,@user: person,Morgan Square: location,M
Jerry Jeff Walker: person,@Pat_Green: person,Songs About Texas
Yoongi: person,@BTS_twt: person
Dynamite: event,TheSong: event,PCAs: event
@Tampa_Bay_Rays: person,@Tampa_
Dead Eyes: group,Jared Kushner: person,@Common_
@Phil_Gould: person,Australia: person,World Cup: event
Black Lives Matter: event,YouAintBlackCongressional Candidate: person,
Manchester: event,Liverpool: location,MCIMUN: event,@Liver
Black Voices: person,Apex: person,Alicia Harmon: person
@YouTube: person,@Shania_Twain_:
@user again: person,Wlw: person,Lesbian books: person,
Trump Supporters: group,@Forbes: group
@user keychain: person,WA: person
Tomorrow 's: event,@user: person,@user: person
@Ted_Lasso: person,@Ted_Las
Fight Breakdown: event,@user: person,@Robert_Whit
@JrMasterChefAU: person,@MasterChef_Australia: person,@Master
@Reliance_Jio: person,Prime charges: 990 /
Black Lives Matter: event,@KMOV: event
Lordt they dun: person,@Mary_J._Blige:
@UNCW_Basketball: event,@UNCW_Basketball: event
________: person,Tobias Harris: person,
@Ransom: person,@TIDAL: person
“If you really want to embrace a new normal, I invite you to turn your heart
Dak Prescott: person,@Dak_Prescott: person
@Andy_Cohen: person,@Anderson_Cooper: person,
@PSAcard: person,@PSAcard: person,@PSAcard:
Wonder Woman Store: product,Warrior Princess Wonder Woman: product,Redemption Mu
GPT-3 chatbots: person,@user: person,company: person
Zombies: map,@user: person,@user: person,@user:
Wonder Woman: person,Bosslogic Planet: person,Voyager:
Porcelain Gold Rimmed Drinking Glasses: product,@Et
Phenomenal season: person,@user: person,You guys: person,
Country Party: group,Aupol: group
Stephen King: person,Trump supporters: person,2016: event
@NHS Coronavirus: product,@NHS Coronavirus: product
Tom Brady: person,@YouTube: person,@Tom_Brad
Crisis DogBus: product,DailyBus: product,Daily Mail
Masters spoiler alert: event,@Scott_Hanson: person,@Re
Fanmeet: person, Bittersweet: person,@(SEVENTEEN
BritishF4: event,Snetterton: person,Browning: person
Champion: person,@Novak_Djokovic: person,we went through
Winter Storm Warning in effect: event,Wintry mix possible: event,Wintry mix possible
sebongs: person,@(SEVENTEEN): person
@Teofimo_Lopez: person,fair fair and square:
BaTorrent: person,LatokenApp: person
Steelers: person,league: league,league: person, RavensFlock: person
Stanley Cup Final: event,Chockey: event,Chockey: event
Candlestick Park: event,SFGiants: group,@Etsy:
New Years Eve: event,You Are Not Alone: person,@YouTube
@TRAVIS_SCOTT: person,L Lit AFfff: person
Pfizer: person,@New_York_Post: location,@New
@Air_Canada: person,It’s been almost a month since I cancelled
TSA: person,@BTS_twt: person
@user: event,DMDUSandcastles: event
Richmond: person,Black Lives Matter: event,@user: person
Biden: person,Pennsylvania drive-in rally: event
AEW: person,T-Shirt Factory: person,The TV Show: person
@Foundation_: person,@Foundation_: person
RoyalCaribbean: group,Royal_Caribbean
@user and @Jill_Biden: person,TrumpWeLoveYou:
You Cannot Kill David Arquette: person,You Cannot Kill: person,New Years
WrestleMania 37: event,Response: product,@user
Ted Cruz: person,Hazel: person,Cancun: location,@D
@Las_Vegas_Raiders: team,@Kansas
Listen & Download: group,The Black Keys: group,David Kream
IWANTASAP: group,ELLA: group
San Francisco mayor: person,@Google_News: location
Australians: event,@The_WOMBATS: event
Covid: person,person,person,person
Dalit: person,CatholicChurch: person,India: person,Ne
Hunter Biden: person,@POLITICO: person,Billy Biden
@user: group,lilyan: group,milk: group,wesgreen:
Julio Jones: person,Viens: person,@user: person
Mcgregor: person,UFC: event,David Cowboys: person
COVID 19: person,Billionaire Boom: person,@Economic_
San Francisco: city,US: group,@Business_Insider_: group
@Transport_for_London_: person,@Mayor_of_London
Lucy Hodson: person,@BBC_Radio_3: event,Blackbird
NitroEx: person,Nanx: person,BTC: person,ETH: person
@Hillary_Clinton: person,Pitdits: person,
@euronews: event,Syd Moore: person,Syd Moore:
Maddie: person,my aunt: person,my dog: person,my dog: person
Imeenda Rome: person,Italy: event,Europe: event
Magic happens when you use the power of your heart and mind to create reality. Miracles happen
@Lady_Gaga: person,@Taylor_Swif
BringTheBoxToIndia: event,CHANYEOL: location,India: country
Balaji: location,Balaji: location,Balaji: location
@Cleveland_Browns: person,@Cleveland_Brow
@Aya_Nakamura: person,@Aya_Naka
Jupiter: person,Io: person,Sir my dislike of Jupiter: person,
The Power to See What Does Not Exist and Make it Happen | BIZCATALYST
John Longmire: person,Port Adelaide: location,Salem Oval:
Yup Blue Weekend: event,Amyl: person,The Sniffers:
Kevin Durant: person,USA: person
@YUNGBLUD’s_a_FLEABAG: person
PREMIERE: person,@user: person,Music video: person,travelin
Buffalo: team,D: team,TakeFlight: location
@Atlanta_Police_Department: location,Pryor Street
@user: group,swan: group,swan: group
@Oklahoma_Football: person,God Bless:
teumes: person,MAMAVOTE: person,@TREAS
Foster Trumpian Narratives: person,Kyler Derby: event,K
@IDK: person,Rolling Loud: person,@IDK: person
Sarcastic: person,Small: person,Face Mug: person,
UK charity: event,@Ali_Plumb: person,New Year:
@Gary_Ellerson: person,@leroy_butler: person,
Curnow: person,Aretha Franklin: person,Goldstein: person
Jack: person,J97: person,JackJ97: person, LayLaLa
@THE_VOICE: person
Thailand: country,Corona-pandemie: group,The Sound Of Silence
@A_View_from_the_Terrace: event,@A_View
@Kerala_Police: person,@CPI_(M):
ClimateFwd: event,@The_New_York_Times:
I need to grocery shop. I need to get a gallon-sized water bottle.
Spotify: product,Music: product,Never Digitalized: product,@iTune
NowruzMubarak: person,Iran and Kurdish: group
Chiefs quarterback: person,Super Bowl MVP: person,@HuffPost_Ent:
Mclaughlin Group: person,@Patrick_J._Buchanan
@iHeartRadio_Canada: person,@iHeartRadio_Canada: person
VotersAssemble: event,@Kamala_Harris
Hurricane Delta: event,@ABC_News: location
Pitt Panther: person,@user ambassadors: person,@user ambassadors: person
@Battlestate_Games: group,playerscav: group,player
Ricky DIllard: person,@YouTube: person,HappyFa
Bryan Thompson: person,@Utah_Football: person,
CRAVITY: person,@CRAVITY: person
Burning Hot Babes: product,Nora Fatehi: person,
@Atlanta_Braves: person,@Atlanta_Bra
NSW woman dies of blood clots a day after receiving COVID vaccine
@School_Education_Department,_MP: group,@Inder
@Bianca_Belair: person,@Mercedes_Var
Porzingis: person,@Mark_Cuban: person
Trump supporters
@user: group,Debate2020: group
"You have to learn to distinguish the voice of God and the voice of your frustration ,
Dr. Anthony Fauci: person,Americans: person,Labor Day: event,
Wimbeldon FC: person,@Warren_Barton: person
UFC 265: event,Lewis: group,Gale: group,
@Sunday_National bit: group
@user: person,@user: person,@user: person,@user: person
@user: person,BirdSidNaaz: person
@Houston_Astros: person,@Los_Angeles
OptixEQ Race of the Day: event,Santa_Anita
Html: person,@Twitter: person
Drew Brees: person,@user: person
POTUS: group,Biden: group,BidenHarris:
U.S.: event,Brazil: location
@BTS_twt: person,@BTS_twt: person
Demi Lovato: person,@Sam_Fischer: person,Dem
Welcome To The Playoffs Champ: product,@DistroKid: person
Green Bay Packers fans have strong , but divided , feelings on player protests ,
NorwegianRoyalFamily: group,New Year: event,Lorrain
@(G)I-DLE()
JJ: person,@AJ_Cook: person,Fate: person,
Adam Toledo: person,@user: person
christmas came early: person,@user: person,Iloveyou: person, Te
Trump supporters without masks: person,@Yahoo: event
Wrestlemania: event,@Bobby_Lashley: person,
World Read Aloud Day: event,WWE: event,WWE: event,
Red Sox: person,Dave Roberts: person,AlCS: person
East Belfast GAA club: group,Catholics: group,Christians: group
Human Centipede: person,2009: person,Movie Review: person,
The power of # storytelling (the # mythological structure) URL via @user
Drishyam 2: video,@Mohanlal: person,@M
RLCS: person,@Rocket_League_Esports:
Football365: person,Chelsea: location,Factors: event,
Cowboys: person,Gameday: event,NYG: person,NYGv
Martin O Kilmer: artist,Dance Mix 2021: event,@YouTu
Clyde: person,switch: person,SPShow: person
Oxford: person,Possitive: person,AZ: person
@user: person,Bosch Sports App: location
Watergate: event,@US_Embassy_to_Yemen
Fight night: event,@UFC: group,@Samuel_
New Years Eve: event,New Years Eve: event,hotmenphilippines:
@Timbaland: person,Rowing Loud: person,@Timba
Chelsea: person,@Chelsea_FC: person, ChelseaManCity:
* New podcast episode * Are You Getting Stuck in the Conversation Red Zone ? 
Serotonin: person,@Sara_Bareilles: person,Hollywood
Permission to dance MV: person,@BTS_twt: person,
Southgate: group,Italian anthem: group,@RT: group
Monarch Fedora: person,KIRK: person,DABABY:
World Series: event,@SFGiants: event,@SFGiants:
Ohio State: person,Iowa: person,NY6: person,Woo
Lil Wayne: person,Scottie: person,@YouTube:
@RodWave: person,Miami: location,Rolling loud
Army: group,@BU_Men's_Basketball: group,T
Tuchel: person,Cameron: person,Man City: person,MCI
Oregon: person,@grist: person
@The_Lincoln_Project: event,Trump: name,Du
Trump: person,@YouTube: person,Trump: person,Fa
@Louisville_Baseball: person,@Louisville_Baseball: person
EXO: group,@YouTube: group,@YouTube
SCAvEDI: person,@Scarlets_Rugby: person,
Labor Day weekend: event,Midwest: location,Midwest: location
@BLACKPINKOFFICIAL: person,The ALBUM: person,S
Nigerians: person,@Olamidé: person,nairamarley
Steiff: company, Teddy bear: company,@Amazon 35: company
i want to know what i want to do
Holy Church of Grabba Sunday Sermon: event,@user: event,@user
New Year’s Eve: event,@Target: person
TommySkeoch: person,Natalie: person,NathanUt
@user: person,RnBMusic: person, Ladies: group
@Joe_Biden: person,@Joe_Biden
@Minerva_Academy_Football_&_Crick
Meléndez and Ortiz: person,Trump-era: person,Re
ARASHI: person,Partystarters: person,SHO: person,S
@Book: person
Leaders: group,Questions: group,@Marker_by_Med
Donald Trump Melania: person,@HollywoodLife: person
Cloud: event,Data Integration: event,7wDataEvent: event
Trumps New Years Eve party: event,Real Ice: event,Real Ice:
Walking Dead: event,TheWalkingDead: event,TWD: event,
Black Lives Matter: event,Trump Tower: event,@New_York
@BTS_twt: person,@BTS_twt: person
Labor Day weekend: event,@user: event,bella bianca dinnerware:
Kershaw: person,Buehler: person,@Los_Angele
Jill Biden: person,Real House: event,Green Jewel-Toned
GhostNation: group,@Jason_Hawes: group,Ste
Vintage Italian Beautiful Woman: person,Long Hair Italy Coin Cufflinks: person,
@Chicago_Bears: person,super bowl: event
Luke Shaw: person,Red Devils: person,Red Devils: person,
Zinger: person,@Xander_Schauffele: person,@Sepp
Georgia State Bar: person,@The_Epoch_Times: location
@7-ELEVEN: person,@7-ELEVEN: person,@
2023: event,@Bop_Daddy: event
@Taylor_Hall: person,NFL: person,NFL:
GrimReaperOfTheSenate: organization,MoscowMitch
@NeNe_Leakes: person,DecemberBabies: event
SupernaturalBenefitsoftheNewCovenantBloodofJe
Tigray: group,Italy: region,TigrayGeno
@mewsuppasit: person,mewSuppasit: person
@Lay_Zhang: person,@Lay_Zhang: person
@Raymond_Arroyo: person,Christmas Special: event,@Ray
FBI: person,Trump: person,Secorting Biden Bus: person
@National_Guard: person,US: person
Nigerian: person,@Babajide_Sanwo-Olu
$ EXMR holders will have a great New Years Eve. Huge News are coming
ARCHER: person,NBA 2K21: event,@user: person,
"People have the right to film the police , and efforts by the police to inf
freeze focused playlist ft: event,@TOMORROW_X_TOGE
@997NOW: person,Warrior: person,Shawn Mendes
Trump Interior Hire: White Supremacist: person,Called Black Lives Matter:
Pubs: group,clubs: group,music venues: group,library: group
Oklahoma: person,Italian: person,5 Tribes: person
NP: person,Number: person,@user: person,Lil
@Match_of_the_Day a lot of fans are back in the grounds
therapists: person,@user: person
@NBA: person,@LeBron_James: person,flops
@Baekhyun_EXO: person,@Bae
JusticeForAdarshMembers: person,@PMO_India: person
Spotify Dia 1: product,13491,639: product,Dia 2: product,
Red Velvet: person,@YouTube: person,@YouTu
Manchester City: Community Shield Date Set: location,@user: location
bts special card: person,Red 7 card: person,@UNO
UFC 265 results: event,Torres: person,Yadong
@Josh_Mandel: person,@Josh_M
@user: person,B2B: person,@burleigh Beach: person
Ride With Me: person,mental Health Awareness Charity: person,mentalHealth: person,PTSD
@Meghan_McCain: person,@Meghan_M
Bad Girls Club: group,@user: group
@Timothée_Chalamet: person,super bowl: person
Congress Government in Chhatisgarh: location,@Bhupesh_
@Medium: product,@Medium: product
Iowa State: person,BCS: person,@College_Football
Community Update: event,State Champs: event,DtBHS: event,
Nevada Trump supporters: person,@Yahoo: person,You may as well
CNN 's Don Lemon: person,Trump Supporters: person,@The_
John: person,Lil Wayne: person,Rick Ross: person
ABC: event,GreatBarrierReef: event,@abctv
Clubhouse: person,@Dispo: person
@Bruce_Springsteen: person,Super Bowl: event
RIPdrake: person,flying@user: person
Middle of the Road: product,Level 78: product
SweetCarolina: person,@Lacey_Chabert: person,@
Liverpool: person,Lois: person,@Fabrizio_Romano:
Dustin Johnson: person,Masters: event,@Jim_Souhan:
@user 's broadcast: location,Full Coast: location,Turkey
@SZA: person,@SZA: person,Teacher: person,
Martial: person,Puma: person,@Nike: person
Environmental Inequalities: event,Policing Protest: event,Policing
LYS TEASER: person,@user: person
@Dak_Prescott: person,Jace: person,Jace
Credit to @user: person,She: person,The Devil: person,The Devil:
@bigbasket: person,food: product,food: product
Fight The Power: product,@PUBLIC_ENEMY: product,The
@Zane_Lowe: person,Wo: person,New Music Daily
Urban Meyer: person,Michigan_Football: person,@D
Labor Day: event,COVID-19: event,@NBC_News: event
Nigerians: celebrity,Boston City: celebrity,Liverpool: celebrity,
@Google_for_Startups Founders Academy: group,Black,La
German Pilot Draws Giant Syringe in the Sky: event,@Luke
Glenn Frey: person,The Heat Is On: product,@YouTu
Rami Malek or Jared Leto.
Happiness: group,@ColorsTV: group,@Voot:
Titans: person,@Jaden: person,@user: person
Ras Midas: person,Radgae Chalet: location,Radio
Koryn Hawthorne: person,You Still Love Me: person,@
PullTheTRIGGERWithVRVR: person,VERIVERY: person
Raheem Sterling: person,ManCity: club,Harry Kane:
@Aljamain_Sterling: person,@Aljamain_S
The Dark Side: product,Level 2: product
Trump: person,Vigilant: person,Labour Day Weekend: event,@The
Eagles coach Doug Pederson: person,Jalen Hurts: person,
Kunfu pandya: person,@hardik_pandya:
Someone Saved My Life Tonight: person,@Elton_John: person,@E
Kamala: person,Trump Supporters: person,LIE: person,@
Ice Guys: event,@user: person,ice Guys: person,ice Guys: person
Club House: event,@user: event,EverydayEthiopia: event
Mat B: person,WrestleRome21: event,@Brandon_
Manchester United fans: person,@Arsenal: person,@Ars
Jokhon: person,@RabindranathTagore: person,
VanjossExclusive: company,StarFM CupidSanta
Trump: person,Roseland: person,@Julian_Z
@user: person,distractedPixie: person
Houston smashing: person,lord: person,zone: person
YouTube
@Killian_Woods: person,@Donal_MacNamee
Elephant Hexagon: group,Australianmusic: group
NOW LIVE on URL 4 x Match Singles: person,1
@user: event,St. Albert: event
Rhythms. ": group,@Sum_41: group,All Killer
The Apostles: person,Spiritual Spirit: person,PreparingForThe
Dragonfly Fabric Face Mask: product, Adult Pleated Handmade: product
Labor Day: event,American Worker: event,Labor Day: event,Labor
@Dan_Rosen: person,Skype Cup Final: event,
10 Side Hustle Skills You Can Master During This Labor Day Weekend via @Entre
@Olivia_Rodrigo: person,@Olivia
Norman: person,@Geoff_Gustafson: person,@Hall
@Cori_Bush: person,endangering the lives of her constituents:
@Tom_Ballard_#80aday: person,@Dan_
Classof2021: event,work,work
Royal Life Church Int'l: event,@WordPress.com: event
Devon: event, Dorchester: event
Max Gawn: person,@inkl: person
@ARASHI: person,MTV: person,FridayLivestream: person,A
Poshmark: person,Radolph Duke Dress Plus Size 1X: person,
California flip: event,@Conservative_News: event
TanushreePandey: person,media: person
@Liz_Claman: person,CDC: person,vaccines:
U.K. intelligence service: group,MI5: group,Russia: group,China
@HuffPost_Politics: group,@HuffPost_Politics
The Power of Us: event,@Telegraph_Business: organization
@user_twitter: event,Bobs games: event,Bo
brisket
@WA_Police_Force: person,@DFES: person,@S
Penn State: event,@DraftKings_Sportsbook: event
Bonne Année: person,New Years Eve: event,PST: event,@user
@Andy_Day: person,@Andy_Day: person,@Andy
Truth and Grace Homeschool Academy: group,Author: group,Library: group
@mewsuppasit: person,mewSuppasit: person
Clemson: person,Ohio State: person,Clemson:
Russell: person,@Mercedes-AMG_PETRONAS_F1_
Raksha Bandhan: person,Your family: person,@Allu_A
snl: group,kristen: person,@Saturday_Night
Russell T Davies: person,Chris Eccleston: person,Maine Road:
LEGOStarWarsHolidayContest: event, LEGO Digital Designer: person,B
Trump supporters: person,@Yahoo: person,American: person
U.S.: product,Covid vaccine manufacturer: product
@Prince_William_County: person,@Prince_W
San Francisco Mayor Breed: person,Nancy Antoinette Pelosi: person
Wrestlemania: event,@WWE: event,Wrestlemania: event
Block the Road: event,Fay-Ann Lyons: artist,caribbe
Snowy Breck: person,Winter Storm: event,Winter Storm: event,
Footballers: group,ex-footballers: group,@Gary_Ne
@Mick_Schumacher: person,@Haas_F1_
@Department_of_Justice_(DOJ)
@euphoria: event,@Hunter_Schafer: person,
@Howard_WGR: person,@WGR_550: person,@Jeremy
Johnson & Johnson COVID vaccine: product,@Daily_Mail_Online
Arghhhh: person,ToMyOnlyXiu: person,XIU
Covid-19: event,situation report for week ending 12 September: location,@Brian
Maldivian Rufiya: person,VISA cards: country
@SB19_Official_: person,SB19onSNL
URL via @Amazon: person,@customer: person,@
Reba: person,@REBEL_not_reba: person,A
@Runtown: event,IF E HAPPEN FOR LAGOS: event
CecilyStrong: person,@Saturday_Night_Live_-_
Hip-Hop Boombox Teddy Bear T-Shirt Urban Picasso Art URL via
Haotong: person,PGA Championship: event,Haotong: person
Shinee: person,BistrodeSHINee: person,Shin
Grace of God: person,@user: person,Happy Anniversary Soso: event
Joshua: person,Joshua: person,Jonathan_Capehart
Middle of the Road: product,Level 86: product
@user: person,@user: person,@user: person,@user: person
UNAN: person,Apertura: person,UNAN: person
@Joe_Biden: person,@Kamala_Harri
@Maurice_Hooker: person,@Maurice_Hooker: person
TropicalStormHenri: event, RhodeIsland: location
France
Parker Messick: person,@FSU_Baseball: person,E2:
Love In The Air: person,@_GFRIEND: person
@Sophy_Ridge: group,Starmer: group
AxumMassacre: event,TigrayGenocide: person,
Rumor: person, Angel Hernandez: person,New York replay booth: person,@ML
Sundowner: event,@user: event,Sundowner: event,@
@New_Orleans_Saints: group,@New_Orleans_
@Solana: company,@Solana: company,@Solana:
@Walmart: group,jobOrTheJab: group
@ocado: person,customer: person
Free information: name,@The_Register: group
Nick Foles: person,@ESPN_1000: person
Super straight: person,@Blaire_White: person
Anthony Sings: person,Camilla Erivo: person,The Voice
@Deontay_Wilder: person,Norway: location,Je
#NowPlaying ' Photograph: product,The Voice Perfor: product,@J
@Mariah_Carey: person,@Mariah_Carey
@kurtis_conner: person,California: person,
UFCVegas32: event,@Michael_Chiesa
@user: person,myspace: person,myspace: person
SKZ: person,Landlevanter gais: person,SKZ:
THE JOKER: person,The Dark Knight: person, Vinyl: person, Auction:
Shades of The Usual Suspects: person,LineofDutyFinal
World Class pianist: person,Carol of the Bells: person,@Chl
@NYC_Public_Schools: group,COVID19: building,NY
Morikawa: person,Masters pool: event,Open Championship: event
SpiritualSunday: event,@Dr.GURMEET_RAM_RAHIM
Kansas City Chiefs' Patrick Mahomes: person,Tom Brady: person,Super
@Audius__$AUDIO: group,NFT: group,C
VB: Final: event,MSU: event,@user: event,Na
Terimakasih: team,@Chelsea_FC: team,
Sunday special: event,RWMOH: group,JESUS: group
@BTS_twt: event,@BTS_twt: event
"Learn to discover the voice of God . Learn to be still and learn to
3090
Kentucky Derby: event,@Big_Cat: event
@ABC: person,@Frank_Valentini: person,GH
Fat Joe: person, DJ Khaled: person,Amorphous: person,Fun
@New_Orleans_Pelicans: person,@New_Orle
TWICE: group,Whosfan: person,TWICE: person
Christmas: event,@user: group,Gigi: group
JAM: person,Man City: person,Ada: person,The Blues
URL: person,player 2042: event
@Ron_DeSantis: person,@Ron_DeSantis
Dublin City: location,An Bord Pleanála: location,James Joyce
Long running hard rockers @L.A._GUNS: group,@L.
@The_Telegraph: group,@The_Telegraph: group
DJ Cheyanne Blues: person,ClubFree: event,WorldWideBlue
Japan women: person,China: event,Hoots: event,Hippoly
Rafa: person,@Rafa_Nadal: person
Nick Foles: person,Bobs controversy: event,@New_Yor
ARCHIMEDES BANYA in San Francisco: location,San Francisco: location
Tizamagician: person,@user: person,@user: person,R
Pixies: person,Monkey Gone To Heaven: person,@YouTu
Trump: event,@NBC_News: group
Rosamund: person,@user: person
@Scott_Morrison: person,UK: person,UK: person
Happy new years eve everyone ! this year I just wanna wish everyone on to
@Activision: group,Havec Sawmill: group,Warzone:
Punchy: person,@Ellen_Johnson_Sirleaf
President Joe: person,USA: person,@Bloomberg: person,COVID
FBI: group,Trump supporters: group,@Google_News: group
DestinedSidNaaz: person,@user: person
"Don Life": person,Lil Wayne: person,@TIDAL:
@sun_SUNBIRDS: person,@sun_SUNBIRDS
LFS: person,@user: person,me: person,agervig: person,
Drivers License: person,@Olivia_Rodrigo: person
@user: person,@user: person,@cap: person
Lil Baby: person,Lil Durk: person,@TIDAL:
Pence: person,Hazel: location,Trump quarantining: event,
@HYBE_OFFICIAL: person,@BIGHIT_MUSIC: person
UX Researcher & Designer: person,San Francisco: location
New Years Eve: event,High rainfall: event,Survival: event,@
@IN_THE_FRIGHTS,_Disney's_ESPANT
@KE: person,karachi: person
Israel: person, Palestine: person,Israel: person,Israel: person,Israel: person
Lushy Banton: person,Black Lives Matter: event,CribXR
Cirelli: person,Stokes Cup Final: event,@NHL_on_
@Taiwo_Odukoya: person,WEC:
Car washes clean up their act as UK fights labour abuses URL
Trump: person,@Shaun_King: person
Alex Jankewitz: person,Dan N’Lundulu: person,S
AliJavanmardi: person,Iran: country,Iran: country,@
@PayPal: person,@PayPal: person
Cristiano Ronaldo: person,Paul Pogba: person,Gabriel
Anitta: person,GirlFromRio: person,G
@Big_Ten_Conference: event,@Big_12_Conference:
Power Book II Ghost: person,@Netflix_Is_A_Jok
@Wythenshawe_Amateurs: person,@Wythenshaw
@Olivia_Rodrigo: person,@Olivia
Man City boss Pep Guardiola: person,@NewsNow.co.uk:
Trump supporters: person,@AOL.com: person,FAIR AND SQUARE
Boryeong: company,South Korea: country,@Change_org_
"Arnold: person,@Arnold: person,@user:
Best Group: group,Bittudo: group,MTV: group,
@Buffalo_Bills: person,@Buffalo_B
Tampa Bay Lightning: person,Dallasstars: person, NHL: person
@Ariana_Grande: person,@Pinterest: group
@Vice_President_Kamala_Harris: person
Pass the Fake News Bill: person,@Ahmad_Ibrahim_La
Elyria grad: person,Ohio State: person,Ton
TriNaM: person,TriNaM: person,Vod: person
@NBA: person,Lakers: person,Lakers: person,Lakers:
@Houston_Astros: person,Astros forever: person
Jets: group,Canucks: team,Canucks: team,Canuck
homie: person,TARKOV: person
@Mike_McFarland_: person,@Mike_M
Body Cam: person,Tutah: location,Tuata Police Officer
LISA: group,LISA: group,LISA: group
Gravity Software: product,entrepreneur: person,MakeItHappen: person,
James Cooper: person,Lowry Hotel: location,Lowry Hotel: location
@user: person,Gophers: person
Ca n't hide the pain inside No-one ever told me that my heart could
Turkey: group,Azerbaijan: group,Army: group,Army:
@user Members: person,@@user Members: person,@Zaidatfup
Peter Dutton: person,Priya: person,@Change.org_Australia:
ENGENES: person,D8: event,EXHIPEN: person,E
UFCFightIsland: event,UFFC253: event
Romney: person,Republican: person,Republican: person,State Court
Chelsea: person,Wembley: location,Wembley: location,We
Apple Music: product,City Chart: product,CDMX: product,City
@Dan_Marino: person,@Miami_Dolphins
[@user’ event]
Native American: native american,Great Fi: nativeAmerican,Navajo: nativeAmerican,
@user: person,HBDIsmartSohel: person,HBDS
F1: group,@David_Croft: person,@Martin
Hurricane Ida: event,New Orleans: location,Battle Rouge: location,
Gary's Movie Review: person,The Suicide Squad: person,2021: person
100milanjoscomerick: person, RavensFlock: event, real
POWER BOOK 2: person,PowerGhost: person,PowerBook2: person
Twitter: user,Trump: group,@Google_News: location
NotreDame: group,Clemson: group,Ohio State: group
Richard: person,Retail: person,@user: person
Derbyshire Dales MP Sarah Dines: person,English Tourism week: event,@
@Bronwyn_Robbins: person,@Bronwyn_Robbins
RedWings: group,NSH: group
NYE: event,@Mixcloud: group,@Twitch: group,
Mac: person,Henry: person,@Daily_Mail_Online:
@user: person,ODP: person,ODP: person, Columbus Crew: person
@Olivia_Rodrigo: person,@Olivia
Greg Fritz: person,@Sanford_Health: person,Bird:
Monroe County: person,@Democrat_&_Chronicle: person,@Democrat_
George Vanderheiden: person,Investment: company,Sundayvibe
AI: product,Advisor: group,Data: group,@Harvard_
VakeelSaab: person,Roju Gurthochindi:
Mike Pence: person,@HLN: person,Russians: person,S
@user: person,smallanyana: person,lighting numbers: person
Bill Gates' Marriage Would Be a Red Flag to Many Christian Couples via @The
@Peacock: person,@Muhammadu_Buhari: person
@nzherald: group,@nzherald: group
Tampa Bay Lightning: person,@Leah_Hextall: person
Attack on Titan: person,@@Crunchyroll: person,@Funim
@Philadelphia_76ers: group,@Philadelphia_76ers
@Too_$hort: person,Salinas: person
National Sisters Day: event,@user: event
Barasirohi kalyanpur: location,Barasiro
@Governor_Kate_Brown: person,@CBS_News
WakeUpwith10: event,@NEWS10_ABC: event
Trump Supporters: group,@VICE: group
Big East: event,@user: event
Coronavirus: event,UK: country,UK: country,UK: country,UK:
Emiway Bantai: person,@Emiwaytweet
Labor Day Weekend: event,City: event,City: event,Klou
@user: person,Sonic The’Hedgehog: person
@Narendra_Modi: person,ModiHaiToMumkin
Biden: person,Detroit: city,Detroit: city,Vi
"A / Way together": event,@user: group,@url: group
Trevor Noah: person,Every Day Will Be Day Of The Dead If Trump Wins: person
Bob Altemeyer: person,@user.com: person,@user.com
Turning Up: event,@ARASHI: person,MTV: person,Friday
Lightning Round: event,David Stars: person,Stadium Cup Final
Jane Eyre: person,Charlotte Bronte: person,@Khaled
Outro: person,cross line: person,@ENHYPEN: person
@Taylor_Swift: person,@Josep
FLAW IN SIMPLE AGENDA: company,LEADERSHIP: group,
@Jimmy’s_Famous_Seafood Squad: event,
BBCYGG: product,PTS: product
@DeRAY_DAVIS:_HOOD_HERO: group,All Section
Suicide Squad 2021: person,@John_Cena: person,@John
@Manchester_United: group,MUFC: group
Cue: person,@Jared_Padalecki: person,TV:
Tropical Storm Sally: person,@NOLA.com: location
Ohio State Cardio-Oncology Center of Excellence: event,MedTwitter: event
@Hugh_Laurie: person, NHL hockey: person,Bolt
Bryson DeChambeau: person,COVID-19: event,M
@Cleveland_Browns: person,@Cleveland_Brow
Sour Beach: event,Sour Beach: event,Sour Beach: event
@Denver_Broncos: person,@Denver_Bron
Chemistry: group,chemistry: group,face mask: group,black and white: group,
@Israel_Adesanya: person,@Paulo_Costa_(_
@PRO: person,@user: person
447: product,Red: product,Black: product,Green: product,99
SpiritualSunday: event,@Dr.GURMEET_RAM_RAHIM
Ottawa 33 - SC 31 | 19:28 2H: event
@Miami_HEAT: person,@Milwaukee_B
@Cleveland_Cavaliers: person,@Cleveland_Brow
Public Enemy: group,Do n't Believe The Hype: group,
Family: group,Psalm 35: group,Ecclesiastes
God Save the Queen (Level 7 ): person
Blaney: person, Hamlin: person,Bobman: person,@
Country Music: person,@user: person,Jaynedenham: person,country:
Victims Of The Beats: person,@DistroKid: person
Putin: person,Russian Federation: person,Russians: person,Russian history
Livestream: event,Mythpat: channel,OP Gaming: event,@Slay
Bitcoin: event,@Bloomberg_Technology: group
@Israel_Adesanya: person,@Israel_Adesanya: person
@Cyberpunk_2077: person,@Cyberpunk_
Breezy: person,start of the second half: person,@user: person
3 / 4 Full Body Burden: person,Kristiten Iversen: person
Poshmark: person,SUN: event,EVE SOON: person,E
Blake Coleman: person,@Tampa_Bay_Lightning:
Kavin: person,Kavin: person,@Kavin: person
Marsabit County as a member of the Interfaith Council.
Seminole County: person,public: event
The Voice search Daily: event,@user: event,ai: event
@Teofimo_Lopez: person,fight
fence: person,dog: person
mountaintop cable car: event,Norway: country,Italy: region
@usertjo: person,Osebeditse baby: person,Lor
WatermelonSugar: product,@Harry_Styles: product,Best