@Columbia_Records: corporation,Columbia: corporation,
SheikhJarrah: person,@user: person
Sister to Sister Meets Shop Talk with Kamala Harris: person,@YouTu
Albin Ekdal: person,@U.C._Sampdori
@Israel_Adesanya: person,Jan: person,Ufc2
@user: person,Christmas: event,Sufism Stevens: person
Education minister: person,Cheif minister: person,board members: person,cancell
@RocketPunch_members: group,@LIGHTSUM
Hahahahaha,ca n’t even win the bottom 2 Premier League teams
Eda: person,Serkan: person,Senalkapimi: group
Browns: group,@Nick_Chubb: person,game: event,@
Puke: person,child: person,true friendship: event
@WhatsApp mobile: product,@WhatsApp desktop: product
Ufc257: person,@The_Diamond: person,L: person
Austin_McBroom: person,@Bryce_Hall: person,
Iran: location,China: location,BTC: product,@CZ__
@UGC_INDIA: corporation,@Shivraj_Singh_
Hollywood: corporation,Mahdi: person,Jesus: person,Je
Policiere: person,D Dig Deep: person,Christmas: event,St
The Walking Dead: corporation,TheWalkingDead: corporation,TheWalkingDe
Turning Up: creative_work,@ARASHI: person,@MTV:
@Aditi_Rao_Hydari: person,@A
Dave Rogers: person,Black Lives Matter: event,Music: product,Tur
@Cleveland_Browns: group,Super Bowl: event,NFL
@Philadelphia_Police: corporation,@Philadelphia_Police
@Listia: corporation,Bowman Chrome: product,Luis Robert MO
@yutohorigome: person,Japan: location,gold:
TNIEeditorial: creative_work,temples: creative_work,@user
@*NSYNC: group,trump: person,halls music: event
Walkin: person,Pooh Shiesty: person,@YouTu
Tokyo Tonight: event,@Peacock: person,Kenny: person
Christmas: event,@user: person
@Chennai_Super_Kings_-_Mask
@ColorsTV: corporation,@ColorsTV: corporation,RAHUL
LaLa: person,@Black_Coffee: person,@Usher_
Covid: person,New Year: event,The Economic Times: corporation
@96.5_TDY: person,LISA: person,BlackPINK: person
@Simon_Calder: person,@Simon_Calder: person
Michigan Trump Supporters: group,Detroit: location,TCF Center: location,
Stream on the ground y gone valoren el esfuer
@Scott_Dixon: person,Indianapolis_Motor
Ole: person,@Manchester_United: corporation,GGMU: corporation
Supreme leader: person,@user ushers: person,Iran New Year: event
Fauci: person,govt agencies: group,CDC: corporation,@Joe
ThePantheon: corporation,Jurassic park: location,@user
US: corporation,World Cup: event,World Cup: event,World Cup: event
Russia: location,China: location,@Yahoo: product
New York blog: location,S / o: product,S / o
Central Jersey: location,@Pete_Genovese: person,
@Bhekisisa: person,George Mukhari: person,George M
Columbus Crew: group,@user: person
Martin: person,kim huybrechts: person
@Aakash_Chopra: person,RCB: corporation,@Aak
Kalbajar Museum: location,Kalbajar Museum: location,Armen
Sophia: person,@user: person,LGBT+people: group,LGBT+
@Jonah_: person,@Daniel_: person,
NowPlaying: event,medline Bradley: person,dremtgi:
Stimulus checks: product,Debt collectors: group,@Ya
Darth Vader Actor David Prowse: person,@Variety:
Gulf morning: event,self-belief and hard work: product,@gulf
Leila Ciancaglini: person,@user: person,dinnerin
Super Bowl: event,@CBS: corporation,apple tv: product
@New_Orleans_Saints: group,super bowl: event,Ram
@user: person,super straight: person
Sleet: group,freezing rain: group,@Tennessean
KEEP GOING STREAM READY TO LOVE URL: creative
Tina Stege: person,Marshall Islands: location,Sids:
Arctic Monkeys: creative_work,The View From The Afternoon: creative
DoctorWho: corporation,@Doctor_Who_on_BBC_America: corporation
Vasiliy Lomachenko: person,Teofimo Lopez: person,ESP
Charles Oliveira: person,Michael Chandler: person,UFC
Hunt: person,second half: event,@Cleveland_Browns:
South Carolina: location,@Lindsey_Graham: person,@
Celtic FC Women: group,BBC Alba: location,@Celtic_FC
@McDonald’s: corporation
Game Two of the Stanley Cup Final: event,@Dallas_Stars:
Carol Dweck: person,TEDxNorrkoping: corporation,Inspi
Bon Voyage: creative_work,@user: person,New Years Eve: event
Jen: person,music video: creative_work,@jlo: person
@US_Army_Fort_Carson: corporation,@US_Army
Nick Cannon: person,Brittany Bell: person,The best gift ever: event
@Supervisor_Catherine_Stefani: person,Marina: location
Preston Smith: person,2019 Grade: +10.40 Average / Game: +0.58
Cowboy Taehyung: person,BTS: group,Permission To Dance
Ram Ram: person,Sabne: person,KD CREATION:
Janelt: person,Ghoddos: group,@Brent
David Guetta: person,Nicki Minaj: person,@Nicki_
Death of 12-year-old boy: event,@South_China_Morning
Sunday Times: corporation,Sportswomen of the Year: event,Rebecca
@Nish_Kumar: person,men of my generation: group,men:
Keyboard slow in IOS 14 on iphone7s: product,@Apple: corporation
@Twitter: corporation,@Twitter: corporation,@Twitter:
harry: person,norcal: location,@Harry_Styles:
Amy Coney Barrett: person,@President_Biden: person,Trump
Vote Your Voice: creative_work,Stand Up: person,St
Poshmark: corporation,Mexican huaraches: creative_work
Game Four of the Stanley Cup Final: event,@96.7_The_Ticket: product
The Daily Beast: corporation,Gary Gates: person,TX: location,T
LionKingCH: creative_work,ClubHousePerformance: product
Deuteronomy 19: event,@Bible_Gateway: corporation
Sundays With Love: event,@ALLY_LOVE: person,The Masters:
Rolling loud: venue,@Nav: person,London: location
Ohio State Football: corporation,CoVID-19: event
dental hygiene diva: person,devil wears prada: person,Ch
@ESPN+: corporation,@Greg_Sankey: person,D
Belfry Middle: group,Pikeville: group,Hillard Howard Field:
@FOX_Sports: corporation,Dodgers: group,@Tamp
Mixtape: creative_work,The Lox Vs Dipset: creative_work
Man shot four times in the head during violent Bronx carjacking: event,NY
Terminator 3 Skynet: creative_work,@YouTube: corporation,T
Lil Nas X: person,Satan Shoes: creative_work,Human
Men 's Breakfast: event,@user: person,@Rancho Cu
Las Vegas: location,Paris: location,Paris: location,Lisbon:
2020MAMA: event,@MAMA: corporation,@Red_Vel
Warner Brothers: corporation,King Arthur: person,Legion of the Sword:
@New_England_Patriots: group,@Tom_Bra
New Zealand: location,New Years Eve: event,NZstreams: product
@Twitter: corporation
Drake: person,Lil Wayne: person,@TIDAL: corporation
@user: person,tnite: event,homie: person
Eastside: location,engineer: person
Sunday Night Main Event: event,Ladies of Skyy Edition: event
Dodgerbaseball: creative_work,World Series disaster: event,@Yah
Trump: person,Biden: person,The Results: event,London studio: location
@FOX_Sports:_NFL: group,Cowboys: group
@Harry_Styles: person,TreatPeopleWithKindness:
Hallelujah Chorus: group,Easter service: event,Easter:
Robinhood: corporation,Robinhood: group,Robinhood: group,Robin
Simon Poile: person,80's: event,@user: person,@Top
Fight Game Media Recap: event,TrillerFightClub: group,
@Minecraft: corporation,Elias: person,Minecraft: corporation
SMH: corporation,73-Year-Old Croatian Man: person,
WWE: corporation,WrestleMania Night One: event,WrestleMania
STANLEY CUP FINALS PREVIEW: event,@YouTube
@Joe_Budden Period: person
@Eskom_Hld_SOC_Ltd: corporation,@
@Matt_Cain: person,@Matt_Cain
@user: person,Silicon Valley legend: person
9NewsAUS: corporation,@user: person,@user: person,@
Tampa grants: corporation,TS Beta: corporation,RBGs seat: corporation,Emy
@NEW_YORK_KNICKS: group,@Boston_
@Mama_Twist: product,mom: person,mo
New Orleans Saints: group,2021 Expert Mock Draft: event,@Luk
@Green_Bay_Packers: group,SuperBowlLV: event
@Joe_Gibbs_Racing: person,@
@Burger_King: person,chicken sandwich: product,chow mein
Kentucky Derby: event,@user Black course: location
Doom Eternal: creative_work,@user: person
National League: group,North and South: group,Nonleague: group,nationalleague
Look At My Records! In Rotation: creative_work,@user: person,@
StopLynchingIndianMuslims: group,India: location,M
Dodgers: group,@Vin_Scully: person
@Conor_McGregor: person,fight: event,khabibvsg
Halo Infinite flight: event,Halo Infinite flight:
Chiefs: group,Refs: group,@Super_Bowl: group
@user: person,Wrestling schools: group,GCWBYW3:
Congress: group,pandemic: event,President Modi: person,@J
Sufc boss: person,@Leon_Wobschall: person
Everything Old is New Again: creative_work,KVGC Interview: creative_work,
@Burnley_FC: group,Pablo: person,@Leed
Dales Pale Ale: creative_work,@Oskar_Blues_B
@USA_TODAY_Tech: corporation,@Michelle_Maltais:
ya go dira walk in the park: event
The perfect storm of global vulnerability: event,Tony Charge: person,@ASPI
@R_O_S_A_L__A: person,@bil
@Peggy_Seeger: person,New years Eve: event,living room:
@VirginRadioVancouver: corporation
Miss Hirlam: person,@user: person,@user: person,@
Ted Cruz: person,@MSNBC: corporation
Raheem sterling: person,@Manchester_City: group,UCLF
Half the world is on fire. The other half is flooding. And the @GOP still
@Human_Rights_Watch: corporation,@Omar_Shakir
Billie: person,Shirley: person,TheLossAd
FBI: corporation,Trump: group,Trump: group,Trump: group,
@Stephen_A_Smith: person,@Houston_Astros:
Bonfire Black Lager: creative_work,@Untappd at Home: location
Flag-flying truck caravan of Trump supporters speed through Marin City, clash with residents
@Robbie_Couch: person,SKY BLUES: creative_work,
Spoiler Alert: event,RayaAndTheLastDragon: creative
Gilbreath: person,Colorado Rockies: group
Lakers: group,Nuggets: group,@LeBron_Ja
Prof . Kwesi Aning: person,IGP: corporation,gangste
Story of Lord Leon and the Gaffer Above: creative_work,The Boy In the Tin
@user: person
Hollywood: corporation,Meghan McCain: person,@TooFab: product
Claimed pasts: person,critical knowledge: product,history production: event,D
@Patton_Oswalt: person,LA Uncab: group,
Treasury Department: corporation,Treasury Department: corporation,Direct Deposit Information: information
@Kygo: person,@Joe_Biden: person,@
NBAPlayoffs: event,@Book: person,40 point triple double: event,
Network speed: product,@JioCare: product
Poshmark: corporation,Tacori Hematite Earrings:
@Mike_Gordon: person,Crystal Ballroom: location
Brianna Taylor: person,Black Lives Matter: event,The After Math Here 
@Amazon: corporation,@Amazon: corporation,Iran: country,
NBA Legends Tournament First Round: event,@Spreaker: product
WWEWatchAlong: event,@WWE_WrestleMania: event,
Jim Montgomery: person,fa cup final 1973: event,@Robbie_Sa
Lemax Christmas Village Figurine Woman Photographer Taking Pictures in the Wind: creative_work
DragonPride: product,State Tournament: event,Hillsboro: location
@user 2021: person,music: creative_work,@user 2021: person
LOINIE BEST ASAP SUNDAY: event
Birmingham: location,@Alison_Hammond: person,Bir
Italy: group,Europe: group,ForzaAzzuri: group,@Na
HPSXRP: product
Linus Sandin: person,NHL: corporation,@user: person
@Polygon_|_$MATIC: corporation,sidechain: corporation,com
@The_Northern_Echo: corporation,Muslims: group,
StageIt: event,@user: person,stageit: event
MOAS: group,D-DAY: event,SPREAD LOVE AND POSIT
BBC2: corporation,Varese: location,@The_Local_
Nigeria: person,Lugard: person,@Osaretin_Vi
Labour congress: event,Government: group,Kaduna: person
Crystal Angel Vintage Taper Candle Holders: product,@Etsy: product,
A9: product,corned beef: creative_work,chopped cabbage: creative
Trump: person,Lil Wayne: person,New York: location,@Yah
Corned Beef and Cabbage Day: event,@YouTube:
Marvel characters: group,@Jon_Favreau: person,MaryJ
James Harden: person,@user podcast: event,James Harden: person
Orioles: group,@Roch_Kubatko: person,
Conjuring: creative_work,@YouTube: product
@Buffalo_Bills: group,striped socks: product
@Philadelphia_Flyers: group,@New_York_
Horse Feathers: person,Pinky 's Fourth Quarter Heroics
Den of the Dead Witch: creative_work,@user: person,@user: person
teamGP: group,primarycare: group,covidvaccine: product,Christ
@Skip_Bayless: person,tampa bay: location,
Bay Hill: location,@apinv: product
@Palaye_Royale: person,@Sebastian
@Dominick_Cruz: person,UFC: corporation,UFC
Chinese on-demand delivery and retail platform @user: corporation,first quarter revenue: 0
Oceans 9: event,@Gillian_Anderson: person,@Sarah
Hell In A Cell Match: event,BCW Hardcore Title: event
@GOP: group,Senate: group,Bully: person,C
Cammi Kol: person,Emerald Lasts Forever: creative_work
An Ominous Sign: event,Katrina: person,New Orleans:
@Olivia_Rodrigo: person,Drivers License:
@Jesus_Culture: corporation,@Kim_Walker-Smith
@user: person,food: product,food: product
Home Alone: creative_work,5 year old: person,@Macaulay_
@Rod_Phillips: person
NowPlaying howDEMONSmove: creative_work,@user: person,
@Joe_Biden: person,trumpmotorcade: product
Corruption: creative_work,Obama 2006: creative_work,Corruption
Black: person,@Education_Week: corporation,@Education_
Jayden: person,University of Michigan School of Engineering: location,@user: person
Parambir Singh: person,SSR: group,Disha: person,@
@Philly_Daily_News: corporation,@CDC: corporation,@
Netflix India: corporation,IndiaWantsAoT: corporation,NetflixBring
Chelsea: group,Leicester: group,fA cup final: event,George:
Stoney Creek Rotarians: group,polio: event,@user: person,
IDA: group,New Orleans: location
Middle of the Road (Level 44): creative_work,@user: person
@user: person,Jeremy: person,Christmas cookies: product,Christmas Eve:
Iowa Football: group,@Hawkeye_Football Strength Coach
StreetJesus: person,UFC261: event,@ESPN_MMA
@Darren_Rovell: person,@Northwestern_Football
Apple Music Kyrgyzstan: location,Solar Power: creative_work,
Sam Johnstone: person,Maguire: group,Van Dijk: person
Blues: group,@Manchester_City: location,Estadio
Nice stream: event,Sans: person,Lmao: person
Edwards: person,Black Trump: person
Poshmark: corporation,Dinosaur animal slippers: product,@
Spotify Global: group,Permission to Dance: event,@BTS_twt
Diamonds Hands Forever: creative_work,He keeps coming with the heat: creative
Black Lives Matter: event,Racial food brands: group,Uncle Ben:
Jewish Biden supporters: person,Trump mob: person,@Joe_
Tyler Huntley: person,@SNOOP: product
@KATH_: person,@Daniel_Padilla: person
@Grey's_Anatomy: creative_work,@Gre
NHL: group,@Murat_Ates: person,@The_Ath
Arslan Yousaf Yakob khan: person,@i
UFC: corporation,Conor McGregor: person,Dunshin Poirier
@Emily_Thornberry: person,@Andrew_Marr:
Joe Biden: person,Racism Lives Here: event,Trump Support
Bradford City: group,Truman: person,Sellars: person,Broad
Deanery Synod reps: group
Dodgers: group,Astros: group,@Clayton_Ker
@Marco_Rubio: person,Republicans: group,White House: location
Naruto: person,JYProFamRequest: product,famre
mitm: person,@TOMORROW_X_TOGETHER: product
Michael Chandler: person,Charles Oliveira: person,Michael
Kumu: person,@SB19_Official_: person
Murphy: person,Cripps: person,Blues: group,Blues:
@Listia: corporation,Mermaid Necklace: product
NASCAR: corporation,Xfinity: event
PhillyGUNViolence: group,Philly gun violence: event,@
Amazon Gift Card: product,AWS: product,Weekstakes: event,
briarchapel neighbors: group,bagels: product,Great Meadow Park: location
Flyers: group,LVPhantoms: group
Volume Máximo Vol . 01: creative_work,@Distro
NWAEmpowerrr: group,NWA: corporation,@Mickie_
Dynamite: event,@LeBron_James: person,Butter
@TradingView: corporation,BTC: corporation,dogecoin: corporation
Matthew Sweet: person,@YouTube: corporation,Girlfriend:
Deoband: person,58 feet high tricolor: creative_work,Happy Independence Day
Stephen Davies: person,The Street-wise Guide to the Devil and His Works: creative_
@UCLA_W._Basketball: corporation,Cal: location,@UC
@user: person,@user: person,STONKS: person
ICE TRAE: group,Tyceno: person,keife
@Stray_Kids: group,@Stray_Ki
NEW MUSIC OUT NOW: person,@user Song Title: creative_work
@Xbox: corporation,@Square_Enix: corporation
KCAMexico: creative_work,ARMY: creative_work,BTS:
queen: person,drawing: creative_work,@YouTube: corporation,
Brexit: event,Covid: group,@Boris_Johnson: person
Chase: person,Blaney: person,@user: person
@BTS_twt: group,tannies: group
Helen Keller: person,KYCINE: product,@Kyle_Ech
@Kardashians_on_E!: corporation,@Kardashians_
Pulitzer Prizes 2021: event,@Forbes: product
@user: person,@user: person
@UFC: corporation,BlackHistoryMonth: event,Michael
NFL: event,Chiefs: group,@Tampa_Ba
Mark and Toys: creative_work,@HackerRank: corporation
Curtis Granderson: person,TBS: corporation,Yankees:
Birch Goddess: creative_work,Sun Wheel: creative_work,Aes
Trump Supporters: group,America: location,@The_Daily_Beast
DONNY MAYMAY FATHERSDAYOnASAP: creative_work,@
Labor Day Weekend: event,@#Power96: product
Easter: event,Easterhunt: event,Easter eggs: product,Easter:
Gabriella: person,Gabriella: person,house: location,browning grass
Pythonista Bot: person,@user: person,@100DaysofCode:
Geordies: group,North East Homeless: group,@user: person
Amazon Prime: product,@Vox: product
City win: person,Chelsea lose: person
Ethiopian authorities: group,Ethiopia: location,@NATO: corporation,@
50 Cent: person,In Da Club: creative_work,@user: person
@Kansas_City_Chiefs: group,@D
WrestleMania Night 1: event,WrestleMania37: event,
Podcast: product,@user: person,@user: person
Billings Preaching Competition: event,VirginiaWoolf
SixTONES: group,FridayLivestream: event,New ERA: event
Bell Fibe: product,@Bell Fibe: corporation,@Bell Fibe
@Tampa_Bay_Lightning: corporation,Blue Jackets
Ziplock bag: product,ball glove: creative_work,grocery bags: product
Flyers: group,@Philadelphia_Flyers: group
RECAP: event,Maryville: person,DefendTheNest: product
@Canelo_Alvarez: person,@Canelo_
@Indianapolis_Colts: group,Ballard: person,Re
@NFL: corporation,extascy league: corporation,ball: product,
Bugs Bunny: person,Easter eggs: event,Easter eggs: event
@Susan_Calman: person,ISIHAC: corporation,Ux
Johnson & Johnson: corporation,CoVID19Vaccine: product,Pfizer
@H-E-B: corporation,winter storm: event
Super Mario Sunshine: creative_work,@user: person,@user: person
GentleO: creative_work,@user: person
The Blues Brothers: group,Thursday: event
@GB_News: corporation,@GB_News: corporation
PepsiCo: corporation,Frito-Lay: corporation,@
GodMorningSunday: event,Holy Quran Sharif: location
WazirXToken: product,India_Ka_Bitcoin_
England: group,SLvENG: group,England: group,@Engla
MathieuCronin: person,@user card: event,Mathi
DPIIT: corporation,NationalStartupAwards 2021: event,@
Warner: person,IPL: event,@SunRisers_Hyder
@Manuel_Delia: person
Labor Day weekend: event,@user: person,@user: person,Cardinal
CNN: corporation,Kyle Rittenhouse: person,@Google_News:
Sumone: person,pen: location,Weeeehaaaaa:
@user: corporation,@The_Besnard_Lakes: corporation,@
Betcha: person,@Gov._Greg_Abbott: person
Obama: person,Navy SEALs: group,White House: location,@Google
HBO Max: corporation,Oscar Winners Wallow in the Gloom: event
Global-E: corporation,Global-E: product,Global-E: product,Global
Charlie Hebdo: person,George Floyd: person,Meghan Markle:
Protest: event,@Blue_Lives_Matter: corporation,BlueLives
NowPlaying Real: creative_work,MICCratesRadio: product,@
Nike: corporation,Black Lives Matter: event,U.S.: location,O
@G_HERBO: person,ari party: event,ishell: person,girl
@Hotpoint_UK: corporation,@Hotpoint_Support: corporation
Majestic: group,roots: group,lupa: group,explos
Morgan Wallen: person,Somebody’s Problem: creative_work,@morgan
Spotify: product,@DistroKid: product
@Revolut: corporation,@ArtStation.com: corporation,payment: product
Labor Day weekend: event,Minneapolis: location,@Pioneer_
Khaos Williams: person,Khaos Williams: person,UFCVega
San Francisco: location,16-Year-Olds: group,@B
Ted Cruz: person,Texas: location,@Nicholas_W
@New_York_Islanders: group,@New_Yor
Topps Update: event,willy Adames: person,Tampa Bay
head highlight: event,@ELZHI: product
Elon: person,Elon_Musk: person,Elon: person,
Pence: person,Trump: person,Afghan allies: group,Ste
@Sussex_Cricket: corporation,Cameron: location
Middle of the Road: creative_work,Level 48: creative_work
BootUp Cam Thomas: person,@Cam_Thomas: person,Tren
@J_O_E__J_O_N_A_S: person
@Apple_Support: corporation
Piggy: person,Kreek: person,Tv room: location,Ma
@user: person,Trem: person,WC2021: event
Biden: person,TX: location,Trump: person,campaign bus
BGYO: group,@BGYO_PH: product
Zealots: person,Jesus: person,MEEKNESS:
Judith Polson: person,SC State Senate Dist 3: event,Rich
Smile: creative_work,August 13: event,2021: event
@Zack_Snyder: person,WW84: creative_work,
Narrow escape for the blues: event,@Chelsea_FC: group
England: group,@Wimbledon: corporation
GQP: corporation,PsakiBomb: event,Foxnews:
Dana White: person,@Tony_Ferguson: person,M
FearMongering: event,Conservatives: group,Republicans: group
@user 3-Day Virtual Showcase: event,SxSW: event,Adrian
Italy: location,@England: location,final: event,euro2021
Van Wert: location,@Allie_Clifton: person,Cougar
ENHYPEN: corporation,ENHYPEN: group,JapanDebut: event
LOINIE WondrousSunday: event,LOINIE Wondrous
TheProdigal: group,@Peter_Okoye_M
Luzon: location,Visayas: location,Mindanao:
@Sea_of_Thieves: person,xbox t
Nigerian: group,@Nigeria_Police_Force Special Anti-
Aaron Rodgers: person,@Aaron_Rodgers: person
TheGlorifiedBlood: creative_work,HOUSE OF THE LORD
FTW New Music Show: event,@91X: corporation,@Dinos
@The_New_York_Times: corporation,Lil Wayne: person
@Robinhood: person,amc: person,nok: person,free markets
TSLA Wall Street: corporation,@Tesla: corporation
IceHaus: corporation,Sun: location,Game 3: event,@USPH
SXSW Pitch 2021: event,@YouTube: product
@ALAYE_TOH_SE_GOGO!: person,Real Madrid
Etsy: product,@user: person,@user: person,@user:
Bolton: location,Blackburn: location,Matt_Hancock: person
@NFL: corporation,@New_York_Jets: corporation,
New Year: event,@Barack_Obama: person,book: product
gold imports: event,gold imports: event,@Minister_of_Commerce
@Detroit_Lions: group,@Detroit_Lions: group
UFC 264: event,Conor McGregor: person,@MMAFighting
Eagles: group,Eagles: group,Top of the 9th: event
Middle of the Road (Level 36): creative_work,@user: person
Jordan: person,@Jordan_Spieth: person,@Valero
@B.R.O.theR._?uestion: person,F
@KSHSAA: corporation,State: location,State: location,State
Dynamite: group,TheSong: group,PCAs 2020: event
Ladies free till 11:30  $ 5 Patron, crown, Grey Goose & wells
Lemon Pepper Freestyle: creative_work,Drake: person,Rick Ross:
@user: person,Philippines: location,PHInternet: product
@GregGutfeld: person,@GregGutfeld: person
Ohio State: location,Greece: person,Free Speech: event
Cyclone Dineo: event,Tsholotsho: location,@N
Daunte Wright: person,Brooklyn Center: location,protesters
Truex Jr: person,blaney: person,@Martinsville_Speedway: product
Patrick Mahomes: person,Eric Fisher: person,SuperBowl: event
The Walking Dead: creative_work,@The_Walking_Dead_on
DoTheTelevision: creative_work,@Jake_Shears:
Coast Guard: group,Sitka: location,Ketchikan: location,
Halloween: event,TREASURE: product,MMM: product,COMEBACK:
@Pep_Boys_Auto_Service_&_Tire:
Acting CMO: corporation,@TheJournal.ie: corporation
Covid-19: person,Tunnel: location,@Financial
The Fight for Police-Free Schools: event,@Popular_Democra
@user: person,Spands: location,Liverpool: location,Cor
@user: person,Flag points: event
Omgfhfhdhdhfg: group,dbd:
Trump: person,Count That Vote: creative_work,Stop the Count
Bill Dodd: person,Louisiana: location,USA: location,American: group
The Winter Solstice 2020: event,vampira: person
PE10s: event,Euro Area: event,Weekly Macro Themes:
DestroyYourDebt: creative_work,@user: person
Bears: group,Brailyn Marquez Time: person,@Blea
Stanley Cup finals: event,@CBC_Toronto news: event,pande
Natarajan: person,T Natarajan: person,T Natarajan: person
@Battlestate_Games: corporation,ACTUAL HACKERS: group,
@user: person,FinTech: corporation,ecommerce: product
Trump rally crowd chants 'lock her up' about Michigan Gov. Whitmer:
Alabama: group,SEC: group,Bama: group,Clemson
Ohio State Football: event,Big Ten Championship Trailer: event,@YouTube:
Penguin5MileRace: event,Penguin5MileRace: event
Bidens: person,White House: location,Inauguration Day: event
@Listia: corporation,PLS: corporation,1991 Score: event,D
Suicide Squad: event,The Guardians: group,The Galaxy vol 1-2: event
African Diaspora Readers Book Club: group,Black Books: group,BlackBooks
@Joe_Biden: person,@Kamala_Harri
@facebookwatch: corporation
VETS in NY: location,@NY_Working_Families_Part
“If it is not from the Lord, it will end in tears ...”
SummerHOTawan: corporation,Andree: person,@ac: corporation
@Cyberpunk_2077: person,@Cyberpunk_
Daddy Yankee: person,@user: person
Boss Lady Rubina Dilaik Anthem: creative_work,R
Drew Brees: person,@user: person
@RUSS: person,Charlotte: location,THREE YEARS AGO:
13: person,Alps: location,Lake Maggiore: location,Alps
The IABC Tampa Bay Daily: creative_work,@user: person,@t
New music on the way: creative_work,@user: person,@Scotl
20 / 21 campaign: event,1s: group,2s: group,@
Super Bowl: event,church: location,superbowl: event
Eritrea: location,Afwerki: person,AbiyAhmed
@Bruce_Springsteen: person,@Marcus_Rashford
Colony: location,@CMO_Haryana: location,@BJP: corporation
Jersey Shore Jam Fest: event,force teams: group,u17 HGSL: group
@Joe_Biden: person,@Joe_Biden
El Clasico 2021: event,Real Madrid: group,Barcelona
Boomers: person,@Nextdoor: product
@thruxtonracing.co.uk: corporation
Woodin Ave , Chelan , Washington , USA Air Quality is Hazardous 
Sangod: location,Supreme Court: location,SaudiaWith
Christmas: event,@user: person,@user: person,troys
Charm City Kings: creative_work,film: creative_work,@Meek_M
Capitol steps: location,Trump supporters: group,@Haley_Willis
Woo: event,Tales of Symphonia: location,Star Wars:
@user: person
@Schitt's_Creek: person,and it ’s even
Trump: person,White House: location,Trump: person,Trump: person,
Kristine: person,@user: person,@user: person,Kristine
Murphy: person,Cripps: person,Blues: group,Kicks
Judge: person,New York Post: corporation,@Google_News: product
Dalit Trade Union Activist Nodeep Kaur: person,@user: person,
@CITIUS_MAG: corporation,TXT: corporation,@Chris
Covid vaccine: product,@Meenakashi_Lekhi: person,@
Queen ’s Gambit: creative_work,Netflix: corporation,@You
CHHOP: corporation,@user: person
Donald Trump Jr: person,Trump: person,Trump: person,Trump:
@Diocese_of_Norwich: corporation,Seven letters to the seven
Petite - Youth Cotton 3 Layer Fitted Face Mask 18 - Made In US by
@user: person,New York City: location
Asides: group,Anna Midnight: person,@Dracmas_Fang
NFL day: event,@Tennessee_Titans: group,TV
Jibei Chuan: person,Chinatown: location,Jibei Chuan: person
Tropical Storm: event,Gulf of Mexico: location,@NWS_Mobile:
Tokyo2020: event,@Anirudh: person
Poshmark: corporation,Under Armour 4D Foam comfy Slides size 11
the view from up here: creative_work,@user: person,@user: person
NCOCcancelexam: event,April 25 , 1996: event,End
Kiwi Co STEM Box: product,hydraulic claw: product,@YouTube
Hip-Hop Boombox Teddy Bear T-Shirt Urban Picasso Art URL via
South Africa: location,@BBC_News_(UK): product,@
Angelina Jolie: person,@Nicholas_Hoult:
Cold War zombies Easter egg: event,@user: person
@user: person,@user: person
BTSARMY: corporation,BestFanArmy: corporation,iHeartA
Cos ah ah: person,stars: group,BBMAs
@Under_Armour: corporation,Star Wars: group,Avengers:
@Castleford_Tigers: group,St Helen '
Lil Nas X: person,MoneRO: corporation,satan shoes:
Womens: group,Miminimizer: product,Swimsuit Size 10
Yoongi: person,@BTS_twt: product
Suave ® Pink TM Line: product,Suave ® Pink
corned beef & cabbage: creative_work,wife & kids: person,
@Houston_Astros: group,springer: person,Yordan
AJR: group,O'Clock Things: creative_work,@AJR
Vice-Chair Kinloch: person,Equity Line Boss: person,
@FS1: corporation,tucker carlson: person,soccer match
Radhe: person,@user: person,@user: person,@user: person
@BBC_Strictly_: corporation,Armography: creative_work
ROSÉ: group,SBS Inkigayo: location,ROSÉ
COVID19: creative_work,@HBKU: corporation,@Qatar
Nancy Goroff: person,@The_Associated_Press: corporation,Still:
@Hulu: corporation,Dodgers game: event
Halloween: event,@Boris_Johnson: person
DiaDeMuertos: corporation,Day of the Dead: event,@BBC
Time Means Nothing to the Dead: creative_work,@user: person,@user
Seige Mentality Pod Ep: event,NFBC: corporation,COVID guys
New Music: product,Weezer: product,@YouTube: product
Stuffed White Camo Deer Head: creative_work,Stuffed Deer Head
Trent Lakes: location,Selwyn: location,Curve Lake: location
@MSNBC: corporation, Johnson & Johnson: corporation,Covid vaccine: product,
Weekend Live: event,Lazy Sunday Afternoon: event,Flashback:
CNN United Airlines Boeing 777 Engine Failure: event,@YouTube: product
@ACU_Basketball: corporation,MarchMadness: event,@
@Simone_Biles: person,burgers: product
WrestleMania Night 1: event,night 2: event,Universal Championship:
Cotton Face Mask and Lanyard: product,Travel Mask: product,Reusable and
Queen of Crime: person,Val McDermid: person,Sunday Blog:
Tears For Fears: group,Sowing The Seeds Of Love: creative_
SixTONES: group,SixTONES: group,Live: event,Six
Toss a Coin: creative_work,Team Venom: creative_work,
GlowUp: event,@BBC_Three: group,autistic
New Years Eve Show: event,Anderson Cooper: person,Andy Cohen: person,
@Twitter: corporation,@jack: person,@President_Bi
California, Oregon and Washington wildfires create dangerous air quality throughout West URL via
Twilight: creative_work,Carlyle: person,@user: person
Campaign rallies: event,Trump properties: location,Hurricane Delta:
The City: creative_work,@Goldfinger: person,exam soundtrack: creative
ALTITUDE RADIO: event,@The_Tragically_Hip
YouTube: corporation,Permission to Dance: creative_work,@BTS_tw
Extremists: group,@UN_Women: group
@Twitch channel: corporation,Glorious House: creative_work,GRR
Dodgers World Series: event,Halloween: event,WorldSeries:
@YouTube: corporation,Shut Your Mouth: creative_work,OFF
NFL season: event,Red Zone: location,@Scott_Hanson:
Defund The Police: creative_work,@Megyn_Kelly
CNNElection: event,Mike: person,@CNN_Politics:
@Olivia_Rodrigo: person,driver license: creative
Eddie: person,EddieGuerrero: person,@WWE:
@MeetBros: person,@Jubin_Nauti
ARASHI: group,@ARASHI: group,@MTV: corporation,
@Dr._Manoj_Rajoria: person,@PMO
@Listia: corporation,@Listia: corporation,Raheem
CaptainMarvel: creative_work,@Brie_Larson: person,Car
African Sun: person,Head in the Clouds: group
Stop Pretending: creative_work,@New_York_Times_
Chidi Amuta: person,@Geoffrey_Onyeam
@Ché_Adams: person,SaintsFC: group,Santa
Winter: event,light: event,@Elizabeth_Dias: person,
WigMaster: creative_work,@Key_&_Peele: person,
Jeremy Parsons: person,San Antonio,Texas: location,Lone
2021: person,@Bud_Light: person,Geek: person
MinutiaMenCelebrityInterview: event,Dave
UAE: location,Auru: location,Auru: location,Auru
Spotlight: corporation,The Devil Inside: creative_work,@user: person
Christmas Eve: event,New Year's Eve: event,@BBC_Radio_
Palisades: location,CD11: person,@Mike_Bonin
Chiefs: group,KVOENews: corporation,@Kansas_
President Museveni: person,@facebookwatch: product
Trump supporters: group,@TheOfficialResidents: group
Realer Heartbreak Face Mask: creative_work,shoprealerbrand: creative_work
Red White andnSports Podcast: corporation,February: event
Glenn Sullivan: person,The Country Ranchers: group,@user: person
@Spotify__: corporation,New Song Love & Life: creative
Zoom: product,PGM: group,More: person,normality: event
State meet: event,State meet: event,State meet: event,State
Word According to KP: creative_work,URL: creative_work,New
Northwestern: group,Ohio State: group,@Ohio_State
OU vs Iowa State: event,@ESPNU: corporation
Las Vegas Nevada Police Department: corporation,Air flight over I The Queen: event
@WDRB_News: corporation,@WDRB_News: corporation
Brick: creative_work,boy: person,dog: person,book: creative_work
Don Lemon: person,Trump: person,@New_York_Post:
Northshire Live: corporation,Tadd Snyder: person,Bundini:
Friday night 's Mind Fluid EXTRA show: event,@user: person,
Maryland 7-Eleven: location,black male: person,black sweatshirt: product,
ESPN: corporation,MegaCasts: product,Ravens-
@Roman_Reigns: person,MITB: group,@WWE: corporation
@user: person,VC: product,Rs 35Cr: product,Rs
Green: person,Jan 6th: event,Royal: group,@
Father ’s Day: event,@user: person,zaddy: person
SCMFL games: event,heat: event,Tuesday July 6
ACDC: group,@AC/DC: group,WhoMadeWho: creative
@Jorge_Masvidal_UFC: person,@Colby
@Gavin_Newsom: person,@Gavin_Newsom: person
Mike DeWine: person,Oklahoma: location,Trump: person,
21: person,@Relevant_Radio: corporation
@Jagat_Prakash_Nadda: person,@Aro
DayZ streamers: group
Jumanji: creative_work,@user: person
HBO Max: corporation,@VIZIO: corporation,Chromecast: product
Best Years: creative_work,@5_Seconds_Of_
Dynamite: creative_work,PCAs 2020: event
Julio Jones: person,@San_Francisco_49ers: group
@Nirmala_Sitharaman: person,@NSitharaman
Blob Opera: creative_work,The Blobpera House: creative_work,
MINIGAME: event,movie: event,Difficulty: event
StrictlyComeDancing: event,@Claudia_Win
New Music Shoot-Out: creative_work,@user: person,New Music Shoot-
Dangerous: creative_work,Def Leppard: corporation,@user: person
Outer Limits: location,Light Brigade: creative_work,@Robert
Winter wave: event,vaccination: event,@Financial_Times
@TreVeyon_Henderson: person,Ohio State:
@Liam_: person,Sunshine: creative_work,
Nets: group,@Kevin_Durant: person
Covid: corporation,Bolton: location,Covid: corporation,Brex
BRONCOS: group,TOROS: group,@ caraballoscore
China: location,Blockchain-Based Service Network: corporation,Blockchain-Based
Trump: person,Super Bowl: event,@Dana_Bash: person
CDC: corporation,vaccinated people: group
Paradise: creative_work,IMAGE: group,music video: creative_
Tonyrefail 3G: product,@user: person
teume: person,Jihoon: person,MC JI
Dynamite: group,TheMusicVideo category: event,PCAs 2020: event
Jacksonville: location,@Houston_Texans: group
@Stray_Kids: person,@Stray_Ki
Reckless: person,The Movie: creative_work,Kids In America
Bruno Mars: person,@facebookwatch: product
Easter service: event,@YouTube: corporation,Easter: event,Thr
Poshmark: corporation,Nike Size 10 US D / MS / X
Microsoft: corporation,girls: group,trans: group,@Change_org_
Tigray: location,@Antony_Blinken: person,@Michel
@ERCOT: corporation,@ERCOT: corporation
@Jamahal_Hill: person,Paul Craig: person,@Jam
Lee Kiefer: person,Fencing Women ’s Foil Individual: event
@MAGGIE_LINDEMANN: person,she knows it: creative_
4MINUTE: product,Volume Up: creative_work,@YouTu
Richard Strauss: person,@Rep._Jim_Jordan:
BraveheartOrBust: corporation,Scottish Bond Films: creative
Nike Precision 3 III Basketball Shoes Black Red (AQ7495-001) Men 's
The vaccine is here . So is the lobbying effort to move to the front of the
@Crazy_Coqs: corporation
Vintage: product,Kraker of New York: location,@Etsy:
Pati patni: person,@Bigg_Boss: person,
Market Capitalism: creative_work,US: corporation,China: location,@Y
WarEagle: group,Auburn_Football: group,
@BTS_twt: corporation,release: event,Midnight 
SGU: corporation,SGU: group,SGU: group,SGU: group
@Arvind_Kejriwal: person,J & K
Easter: event,Easterhunt: event,Easter: event,Easter: event
Iran: location,Khamenei: person,@Al_Jaze
@Francis_Fukuyama: person,@Luis_Fel
Devin Booker: person,Phoenix Suns: group,Chr
@John_Kennedy: person,@Kamala_Harris
French: group,@University_of_Southampton: group,@user:
Cleveland Browns: group,Super Bowl: event,@Arlo_White_
2 Corinthians 3:17: person,Lord: person,Spirit: person
Biden: person,White House: location,Trump: person,@Yah
College Football Playoff: event,Alabama: location,Clemson:
@user: person,ither Utd: corporation,Jim McLean: person
@Carbon_Health: corporation,@LA_Public_Health: corporation,Covid
@Rep._Marjorie_Taylor_Greene: person,
Yoongichi: person,@BTS_twt: product
Mary J . Blige: person,Family Affair: creative_
Disney: corporation,@Loki: person,Episode 1: event
Tony Blair: person,vaccinated people: group,@user: person
@GamecockWBB: group,Tennessee: location,Vols:
NASCAR: event,@Clint_Bowyer: person
@Twitch: corporation,@Twitch: corporation,@Twitch:
Space Trance Mix: creative_work,@YouTube: corporation
Arsenal: group,@user: person,free lunch: event,red Ginger: person,
Da Carter: person,Back 2da Trapp: person,Spotify: product
@Crystal_Palace_F.C.: corporation
Sivaangi: person,Sivaangi: person,Sivaangi:
@Los_Angeles_Chargers: group
Sociable Foodie Fun: event,Metropolitan: location,Cooking
@Breitbart_News: corporation,news only: event,Face
SoFi Stadium: location,NFL: group,Rams: group,Wow
Permission to Dance: creative_work,Spotify: corporation,@BTS_
CHICAGO WHITE SOX 59FIFTY NEW ERA BASEB
Academy: location,LFCU23s: group,@LFCTV: corporation
Wrestlemania: event,@Bianca_Belair: person,
The Police Shooting of Daunte Wright: person,Black Lives Continues:
24 HOURS AND 20 MINS LEFT UNTIL BBMAS VOTING
CovidChristmas: event,@Starbucks_Coffee: location
Genshin Impact: product,@user: person,GenshinImpact:
30: person,Amazon: corporation,Christmas Gifts: product,@user
Warren Littlefield: person,letterman: person,30 years later: event
Super Bowl: event,essay: product,onlineclass: product
Easter: event,Easter: event,Easter: event,Easter: event,
NowPlaying The Bad Day Blues Band: creative_work,The Hustler: person
KFOnlineHost: corporation,@Darren: person,DarrenEspanto:
DONNY MAYMAY FATHERSDAYOnASAP: person
We 've recorded your name: creative_work,Family leave: event,
Binance: corporation,Binance: corporation,BTC: corporation,TetherS
Carmelo Anthony: person,NBA: group,@user: person
@Jack_Harlow: person,@Tyler_Herro: person
@user Wordmasta J: person,Nightmares: creative_work,
Alan Rickman: person,Snapse: creative_work,@user: person
US Capitol: location,pro-Trump mob: group,US Capitol: location,
Monday Funday Ep3: creative_work,Moon Disco: creative_work,
TN: corporation,@News18_: corporation,@Zakka_
Manchester United: group,@Manchester_United: group,@Gary_
Dustin Johnson: person,Masters: event,COVID19: event,@
@Danielle_(Nolli)_Waterman: person
MAGA Election Clerk: person,@The_Daily_Beast: person,
Rashad Robinson: person,media: group,media: group,media: group
Destiny2: product,@Xbox: corporation,Destiny_2:
Flipkart: corporation,Samsung Level U: product,Flipkart
@Kaz_Grala: person,GIVE HIM A FULL TIME R
@GHETTS: person,Mozambique: location,IC3: product
IGP: corporation,PSC: corporation,@user: person,@user: person
Biden: person,W: group,idc: group,trump: person
Chilly Gonzales: person,Christmas music: event,Christmas music: event
Selena: person,De Una Vez: product
2020MAMA: person,MAMAVOTE: event,2020 MAMA: event,
Bizarre: event,COVID: product,@Google_News: product
Wales: group,Six Nations: event,@user: person
Tate: person,game: event,game: event
Happy Valentine: person,@DreamDoll: person,@DreamDo
Ghana: location,@user: person
Vikings: group,Packers: group,SB: group
All Black: group,National Organization: group,Barrington: location,United
@user: person,CASA: corporation,video: creative_work,CASA:
@user: person,first pitch: event,wind: event
Downing St: corporation,@UK_Prime_Minister: person
Sadboy2005: group,Wall to Wall: group,Trish: person
@Top_Rank_Boxing: corporation,@Top_Rank_Boxing: corporation
@user: person
Fantastic Four Pt . 2: event,Feat . Lox, Cam'
Labor Day: event,vanlife: event,vanlifediaries: group,over
@Kansas_City_Chiefs: group,BEAT
Stanley Cup Finals: event,Paradigm Wrestling show: product,@
Dembe: person,Red: person,Liz: person,@HIS
HDSPM BLACKPINK: corporation,BBMA: corporation,HowYouLikeThat
@user: person,TB podcast: corporation,The PewterCast:
Premier Iain Rankin: person,Green Choice: event,Prime: person
New Years Resolutions: creative_work,@Billy_Joel:
Sana: person,Friday: event,MorissetTE: person,@user
Fight Night: event,@user: person,Jo: person,Talks about
New York Islanders: group,@New_York_Islanders:
UFC263: event,Michael Chandler: person,@Charles
Revenge: creative_work,One Cut of the Dead: creative_work,Luc
The United Ping-Dom: creative_work,@BBC_Break
Trump: person,MI Gov: person,@MSNBC: corporation
Refugees: group,migrant workers: group,Libanon: location,
Seahawks: group,NFL: group,Packers: group,injuries
Calpulli Mexican Dance Company: creative_work,Dia de los Muertos
PREVAIL: event,KWOFI: group,KIDDMAIN: group,
SisterDay: event,SisterDay: event,SisterDay: event,Sister
Ariana Grande: person,Biden: person,@Joe_Bi
PinarayiVijayan: person,@TNIE_Keral
Makin it on my own with Ros: person
@AEW_LIVE_EVENTS: group,@All_Elite_
Bills: group,Baysley: person,Cheaps: group
JD & LD: group,Walang forever: event,@Ed
Javasvript: creative_work,Nancy Du: person,@user:
Chanda Kochhar: person,@mewsuppasit: product,M
SexLife: group,BookSparksAfterDark: group
@Nicola_Sturgeon: person,bma: corporation,pfizer
@BTS_twt: group
Lunch at The Chicken Rice Shop: location,@YouTube: product,Pen
heydougie: person,kettlebell: product,New Years Eve: event
@SB19_Official_: group,@SB19_O
Nuala Ellwood: person,BookReview: product
@user crew: group
@Goldin_Auctions: corporation,800 more lots close Sunday night
Artmandu: creative_work,music videos: creative_work,films: creative
Box Office: corporation,The Suicide Squad: creative_work,@Variety:
Minnesota: location,Omari Spellman: person,Jacob Evans: person
@Mariah_Carey: person,whitney: person,@Ch
Middle of the Road (Level 64): creative_work,@user: person
ICYMI: corporation,@user: person,lif: product
@NCSC_UK: corporation,UK: corporation,Israel: location,Spy
Sunday Pwning: event,CoD: event,The Bears: group,
Queen: person,WLWT: corporation,@Cameron_Hardin_
@Philadelphia_Eagles: group,Dow Pederson:
AI Weekly: corporation,@VentureBeat: product
Lil Wayne: person,Ai n’t Got Time: creative_work,
@YouTube: corporation,Zillow Scamming People: product
Tokyo 7th Sister: group,chain: group,chain: group,t7S:
Queen: person,SARAH G: person,Sarah Geronimo:
Kikuyu: person,Dj: person,Gramps Morgan: person
Dynamite: group,TheMusicVideo: group,@BTS_twt
YNW Melly: person,Over the Phone From Prison: creative_work,
Cyber Monday: event,@Amazon: corporation,beauty products: product
Columbus Crew: group,Farmer Cup: event,@_Major_
Christmas: event,@user: person,@user sockets: product
I have my drivers license test on Tuesday. Fingers crossed I 'll hopefully make it
Chimamanda Ngozi Adichie: person,TEDGlobal 2009: event
Marianne Faithfull: person,Fame ’s Dark Side: creative_
@Senate_Democrats: group,@Senate_Republicans:
spotify Thailand: location,@BTS_twt: product
Ohio State: group,@College_Football_Playoff: event
Vibhor: person,Jawson: person,@PMO_India
San Antonio Spurs: group,NBA: group,@user 1032: person
@Ripple: corporation,@Brad_Garlinghouse: corporation,@
PGF Super Select 3-0: event,@PGF: corporation,@user: person
The Dark Side: creative_work,Level 2: creative_work
Romney: person,UTA: location,Joe Biden: person,Trump
Final: event,DivILH: group,Bonzai: person
@Ask_Paddy_Power: person,Super Bowl: event
Tennessee: group,ND: group,TN: group,@user: person
@Crawley_Town_FC: corporation,half 1: event,@C
Chelsea: group,Manchester City: group,UEFA Champions League: event
Sunday fun day: event,golf: event,beverage: product
@Gordon_Ramsay: person
@European_Commission_: corporation,@user: person,@EU:
QUAD Countries: group,China: group,@Dr._S._J
BPP Education Group: corporation,Birmingham: location,Highed:
Spotify: product,Vittoria MEYERS: creative_work,@Di
@Nazionale_Italiana_: group,World Cup: event
Devil In A New Dress: creative_work,Kanye West: person,Rick
Podcast: event,The Number One Reason: creative_work,We Must Break Free of the
@Barclays_London: corporation
Blizzards: corporation,state: location,state: location,@Bliz
@Jeremy_White: person,@Sal_Capaccio_: person
@NM_State_MBB: group,WAC Tourney: event
Nevada State Board of Education: corporation
Pokemon: product,Pokemon: product,VHS Clam Shell Case: product
@Salman_Butt: person,Virat Kohli: person,71
@Elon_Musk: person,Satoshi Nakamoto: person
Brad Lloyd: person,Carlton: corporation,Lachie Plowman: person,@A
@President_Biden: person,@VoteVets
Unfiltered Truth: creative_work,@YouTube: corporation,UnFil
Splytt: person,Music Video: creative_work,RIPPOPSMOKE
Father's day: event,6ers: group,French: group,@
@Everytown: corporation,MomentsThatSurvive: event,N
@The_Home_Depot: corporation,new appliance: product,new lemon: product
Boris Johnson: person,Backyard: location
@UBA_Foundation: corporation,National Essay Competition: event,N2
NCAA: corporation,@Insider: product
Trump: person,Putin: person,Suicide: event,Russia:
Valentines day: event,@user: person,@user: person
KARINA ASAPebIBIG: person
DaBaby: person,Megan Thee Stallion: person,T
Derry City: corporation,Dundalk: corporation,Jamie McGoni
@Andrew_Marr: person,@Boris_Johnson: person
2020MAMA: group,@MAMA: group,@TOMORROW_X
@AKA: person,girl: person,girl: person,@AKA: person
UK: location,UK: location,UK: location,UK: location,UK: location
LYNC LONE: person,MOLEHILLS: creative_work,@
leadership: person,@Keir_Starmer: person
Mary Queen of Scots: person,Line of Duty: event,@martin
Amanda Gorman: person,Super Bowl: event,@NFL: corporation,@Col
Montana: location,Bullock: person,@user: person
Gucci Mane: person,Trap God Classics: creative_work,Verzu
Green Biscuit pucks: creative_work,@user: person
@CD_PROJEKT_RED: corporation,Byte: corporation,C
Mars: location,@Elon_Musk: person,Mars: location
California: location,Coachella: location,Tacoma: location,@S
Steiff: company,Teddy bear: creative_work,@Amazon 34
RunItBack: group,@Drizzy: person
Amazon Alexa: product,kanada radio: product
@azekel: person,Dup: creative_work
Law school: corporation,@user: person,LLB: corporation
Brandon Lewis: person,@Brandon_Lewis: person,@Conserv
Ben Afquack: person,Drumming duck: creative_work,@
@_MONSTA_X: group
@user: person,The Pod: corporation,Making Me Laugh Many Times
Nebraska: location,class A state game: event,@user: person,NEWEST
Inkigayo: person,@UP10TION: event,CONNECTION
Honduras: location,US: location,NPR: corporation,@user:
Covid: group,@Joe_Biden: person,@President
RamMandir: person,@AAP: corporation,Ayodhya
WARZONE VICTORY: event,long weekend: event
Sam 's Club Pharmacy: location,Sam 's Club: corporation,@
agust d: person,Spotify: corporation,PermissiontoDance
The shooting: event,@United_Nations: corporation
Christmas rush: event,@user: person
Shatta-Wale: person,Ypee: person,Azaa
xploremore: creative_work,naija: person,Goodvi
Chinese Ship Deployment Roils South China Sea: event,@President_B
Real Pod Wednesdays: event,Ohio State: corporation,2021: event
Black people: group,BIPOC: group,@Ashley_Lauret
Whiskey 4pc: product,packrafting: product,bikerafting:
England fans: group,@Daily_Mail_Online: product
The Lopers: group,COVID-19: event,Fort Hays State:
@Joe_Biden: person,@Kamala_Harri
On Being Yukiko: creative_work,@user Book Club: corporation,@ja
Chipotle: corporation,rice: product,cauliflower: product,beans
Lil Durk: person,The Voice: creative_work,@YouTube
Etsy: corporation,@user: person,@user: person,Jamill
Secretary of State: person,region: location,@Brandon_Lewis:
Hanukkah: event,New Year: event,Holiday Cards: product,
Raksha bandhan: person,India Railway Apprentices: group
River to River: creative_work,@user: person,Mike Beranek
@Las_Vegas_Raiders: group,Super Bowl Champs:
Wonder Woman: person,84: event,@user: person
@Jake_Paul: person,Nate: person
Trump: person,GA SOS: group,@ABC_News: corporation
250 million dollar contract: product
Smorgasbord Blog Magazine: creative_work,Happy New Year 's Eve
Dodgers: group,World Series: event,COVID-19: event,J
@West_Coast_Eagles: group,Liam Ryan
Meshuggah: group,Nothing: creative_work,Mesh
Twitter: corporation,@Twitter_Verified: corporation,@Twitter_
@Olivia_Rodrigo: person,@NIKI_DE
Errol Spence Jr: person,HyenaGanggSalute:
Oregon: location,air quality: product,@grist: product
@Joe_Biden: person,Senate: group,Deb
2G AND A SHARE OF R2000 CASH DAILY: event,VOTE
@NTT_INDYCAR_SERIES: corporation
Super Bowl 55: event,Bobs: person,@Yahoo
@Taylor_Swift: person,@KATY_PERRY
Who Is The Holy Spirit: person,@YouVersion: product
@Bianca_Belair: person,@Mercedes_Var
RUN BTS: creative_work,@BTS_twt: product,
White Sox prospect Rylee: person,White Sox: group,White Sox
David Murathe: person,jubilee party: event,newsGang:
@The_Conversation_Africa: corporation
@user: person,The Good,The Bad: person,The MVP: person
@News_Breakfast: corporation,Health Minister: person,@Gre
PTI25Years: event,AgainstMafia: group,W
@Joe_Biden: person,VP: person,@Kamal
Joe Biden: person,apartheid: event,@YouTube
Jihoon: person,Jihoon: person,MC JIHO
Chiliz: creative_work,NFTs: product,@Coin_Brie
SiZzles: person,Week’s Menu: event,SiZz
San Francisco: location,@NBC_News: product
Oomf: person,EXO: event,EPISODE01:
New Music: event,Occult X: creative_work,Just Friends:
ESPNDaily: event,@Jeff_Passan: person,Ar
SML 632: corporation,@Xbox Series X / S: corporation,
Apple Watch: product,iOS 14: creative_work,Apple: corporation,@
Super Bowl: event,AusOpen: event
@FOX_Sports: corporation,Red Sox: group,The A:
Nike: corporation,Satan Shoes: creative_work,@Al_Ja
@Scrabble_GO: corporation,@Scopely: corporation,@H
Bears: group,@FOX_Sports: corporation
San Francisco event: event,San Francisco: location,San Francisco: location,S
Y'ALL THIS AWARD MADE ME CONFUSED , ,
Amzn: corporation,Internet bubble: event,Capital markets: group,Sun
Jewish Trump Supporters: group,New York City: location,@user: person
Drew Brees: person,NFL: corporation,New Orleans: location,Fant
Judas: person,Black Messiah: person,@user: person
President-Elect of the United States: person,@Joe_Biden:
Jeremiah 29:11-14 NIV: creative_work,Lord:
Raksha Bandhan: creative_work,Rakhi: creative_work,
Valentine's day: event,Valentine's day: event,@user:
UFC260: event,@Stipe_Miocic: person,@
@Dallin_H._Oaks: person,American politics: event,
Happy new year: event,New Year: event,@user: person
CPWEB3083320: person,South Hills: location,@@City
Karon Beach: location,Old man fishing for food Phuket Thailand: location,@
England fans: group,Wembley: location,Ital: location,@You
Boo Seeka: person,Golding: person,Do n't Waste Your
@Lewis_Hamilton: person,@Lewis_Hamilton
@user: person,njpwstrong: group
Mabima: person,Autodaniel: person,Honeybee
BTSArmy: group,BTS trivia streaming party: event,Dynamit
SSRWarriors: group,@Farhan_Akhtar:
Marenostrum: person,Fuengirola: location,Sohail
Poshmark: corporation,FashionNova: corporation,Legiggins:
@Olivia_Rodrigo: person
Milwaukee: location,Bather: person,Groom: person,Joe
Game Changer: creative_work,Spotify: product,@DistroK
@Priya_Malik ji: person,World Cadet Wrest
2020: event,@The_Ohio_State_University_Wex
LiveTweet: corporation,P5R: corporation,Dr. Maruki
Starmer: person,@Boris_Johnson: person,Labour: group
Super Bowl: event,Frast Bowl: event
@Brandon_Jones: person,NascAR: corporation,
Bill Gates: person,Monsanto: corporation,@YouTube:
@NAACP Units: group,Covid: disease,vaccine education: event
@Kansas_City_Chiefs: group,Patrick
Pompeii: location,@The_Associated_Press: product,Pompe
@Jaden Smith: person,movie: creative_work,movie
NcikaNation: event,BUJWA: group,NO _ DZE
Nick Foles: person,@Philadelphia_Eagles: group,
37bn on test and trace: product,@Boris_Johnson: person
Anitta: person,Girl From Rio: location,@YouT
Gladys: person,@Shaun_Micallef: person
NowPlaying: person,New Music Friday: event
MARCHingSaluteVoteXIUMIN: creative_work,
100DaysOfSwiftUI: creative_work,Day 1: event
Killing Floor 2: event,Dr. Hans Volter: person,Boss
Rick Scott: person,Trump: person,Trump: person,Fraud Party
JetsWhiteOut: event,@Winnipeg_Jets: group
Turk Ft: person,Lil Wayne: person,PhenomStreaming: product
NowPlaying Katie Kittermaster: person,LIVE: event,Music: event
@James_Hanson: person,@BBC_Radio_Bristo
Dave Walker: person,@user: person
happy new year 2021: event,Printable Christmas Decor,new year Print: event,
@Snowfall: corporation
BlackShadowTeam: group,SUGA: group,@BTS_tw
Tyler: person,@tyler_jseph: person,@
Access Strategy & Impact: creative_work,COVID Vaccine: product,
Worship focuses Us on the Lord ! @user: person
@Imran_Khan: person,@Ministry_of_National_
@Senator_Ted_Cruz: person,invasion
@Harpz_Kaur: person,@BBC_Asian_Net
@Green_Bay_Packers: corporation
bbrightvc: corporation
@Isaac_Alarcon: person,@Micah_
@Matisse_Thybulle: person,NBA: corporation
Clippers: group,@Book: person,40 point triple double: event
@YouTube: corporation,Ultimate Die Maschine Easter Egg Guide:
Jerry West: person,@Kobe_Bryant: person,@NBA
Wisconsin Republicans: group,Pennsylvania: location,@Jour
@AJC_Sports: corporation
Edward: person,@JEDWARD: person,Surgeon: person,Dr: person
President Moon Jae-In: person,Korea: location,@user:
The Gold & Silver Bullion Post: creative_work,@user: person,@
CHRISTMAS MUSIC: creative_work,shops,restaurants,bar
LOWER YOUR BEATS And Shut The World Out Of The Room .. 
Covid: disease,blood clots: event,@Financial_
Joe Perez: person,ball 4: event,Dunkout: location,Score
@bright: corporation,bbrightvc: corporation
Atlanta activist: person,Black Lives Matter: event,FBI: corporation,@Google
Kevin Durant: person,Game 5: event,Buzzer-beater: person
@Muhammadu_Buhari: person,@Prof_Yemi
@Jason_Frazer_: person,@Romney_
JIHOON BLUE HAIR JIHOON BLUE HAIR J
MeghanMcCain: person,@The_View: corporation,@Jo
Midway: location,Clash of the Titans: event,June 5: event
Easter: event,Linda Belcher: person,Easter eggs: event,
@NFL: group,Super Bowl: event,Great win for the country: group
@user: person,86 games: group,43-43 each lmao
@Tom_Brady: person,@Tampa_Bay_
Djokovic: person,@NTT_INDYCAR_SERIES:
Hurts: group,@Philadelphia_Eagles: group
Power Book II: creative_work,@STARZ: product,@50cent: product
Middle of the Road: creative_work,Level 21: creative_work
CharmingRapperHarutoDay: event,@TREASURE: product
book: creative_work,Away with the Penguins: creative_work,@user
Biden: person,@The_New_Statesman: corporation
feb 11th: event,Toughones: person,@Alan
Fox News: corporation,Trump: person,@Laura_Ingraham: person
Government: corporation,Newstart: product,Jobseeker: group,New
17 Months: event,Can You Blame Me: event
Old Eyes: creative_work,@user: person,poetry: creative
@Joe_Biden: person,@Kamala_Harri
Georgia: location,@Georgia_Democrats: group
Indian and Chinese armies: group,Ladakh: location,LAC: event,
@Metropolitan_Police: corporation,claphamcommon: group,
Drew Brees: person,Saints: group,@NOLA.com: product
NFL: event,Pegaus Sports: corporation,NW: corporation,RELET
Daunte Wright: person,son: person,@The_Hill_Time
HappyMothersDay: event,MallikaSingh: person
@Deji: person
Christopher Plummer: person,The Sound of Music: creative_work,@user: person
Celtic: group,Ryan Christie: person,@MailOnline_Sport: product
@Roman_Reigns: person,cleveland: location
@Ida_Bae_Wells: person,Cream of Wheat
persecution of a Christian: event,@YouTube: corporation,@user:
Ohio State University: corporation,Wexner Medical Center: location,Covid19 Deaths
IoT technologies and applications: product,@user: person
Harvest: person,Easter basket: creative_work,@DreamWorks_
Jungwon: person,PD-nim: event,@ENHYPEN: corporation
Bodega: corporation,Tekken 7: product,IPP: corporation
@garrytan.eth__: person,coinbase:
@user: person,Pavilions: location,Raiders: group,Big
Israel's Labor Party: group,@Merav_Michaeli
@Los_Angeles_Lakers: group,@Los_
BlackBoysCheerConference: event,@user: person,@
Woodside 's Burrup Hub: location,Adani Carmicha
LFF2021: event,safety and health first: event
Hip-Hop Boombox Teddy Bear T-Shirt Urban Picasso Art URL via
Best Boy: person,@_KANGDANIEL: person
KC Chiefs: group,Super Bowl: event,Kansas City: location
HappyEaster: event,Canni Family: group,Easter: event,Easter
Megaplex: location,@user: person
Tigray: location,Eritrea: location,Ethiopia: location,@
URL NEW BEAT "Night Rain ": creative_work,@user
Watchmen: creative_work,Ultimate Cut: creative_work,@Z
@Milton_Keynes_University_Hospital_NHS_FT
Major League Baseball: corporation,Jennifer Turner: person,Dodgers
Trump: person,Trump: person,Trump: person,Trump: person,
Burnley: group,Aston Villa: group,Burnley: group,U
Ted Cruz: person,AOC: group,TX: location,@Yah
Heidi James: person,The Sound Mirror: creative_work,Heidi James:
@Parker_McCollum: person,To Be Loved By You: creative
SON'S 100 SPURS GOALS: event,Heung-min Son:
@YouTube: corporation,YAKUZA LIKE A DRAGON:
Soccer-Southgate: corporation,England: location,Italy: location
Mookie Betts: person,Los Angeles Dodgers: group,World Series
Katalin Kariko: person,Moderna / Pfizer: corporation
Old Babylonian Version of the Gilgamesh Epic: creative_work,18 Language
SoMJ: person,My Boo: creative_work,WSHH Heatseekers:
The Dark Side: creative_work,Level 12: creative_work
@Spokesperson_GoK: corporation,@Kenya_Pol
India: location,@Pvsindhu: person,Tokyo Olympics
Civic Leader: person,Trump Supporters: group,Vigil: event,@
Trump adviser: person,President: person,Electoral Day: event,@POL
@Olivia_Rodrigo: person,driver license: creative
Cheboygan: person,Newberry: person,Chiefs: group,
@YouTube: corporation,Gettin ' Dirty Under The Bus
@user: person,HYPE: product
zombies map: creative_work,@user: person,CallofDuty
@user: person,Hink: person,Eliza: person,SvenPals
@BlackySpeakz: person,uicideboy: creative_work,video:
Constitution: event,@user: person,Honolulu: location
@Laura_Tingle: person,Morrison: person,Cormann:
11 years later: event,timannaversary: event,datingversary: event
Islanders: group,@Philadelphia_Flyers: group
Number one album of the year: event,I let it in: creative_work,@
@FDC Presidential Candidate Patrick Oboi Amuriat: person,Butam
Biohazard 4 Chapter 4-4 Resident Evil 4 Gameplay mission on PC with No 
@James_Purefoy: person,firefighter: person,
Lil Nas X: person,Satan Shoes: creative_work,Nike
Errol Spence Jr: person,Danny Garcia: person,@user: person
Stanley Cup Final: event,Stars: group,Lightning: group,Corey
Skip Lanning: person,@Melbourne_Stars: group,@S
Tar Heels: group,Kentucky: location,Ohio State: location
@MT_Women's_Basketball: group,@Lady
ABC News: corporation,Trump: person,@Palmer_Report: product
@Pack9_: person,Cardiac Pack: person
Cold war Zombies Easter Egg: creative_work,Speedrun attempt: creative_work
BALT: corporation,Holy Bible: creative_work,Proverbs: creative_
WrestleMania Night 1: event,@Cesaro: person,
@user: person,Million MAGA March: event,Trump Supporters: group
Biden: person,Democrat theater: product,@user: person
Future: person,@Mark_Z._Jacobson: person,@
@Bill_Maher: person,media study: creative_work,@B
People on this plane: location,VaccinePassports: product,American citizens: group
Trailer for director Tucky Williams film girl girl scene the movie .. . I
Takemeback: person,Libanon: location,unpopularopinion: group
Myrtle Beach: location,Colin Morikawa: person,Open Championship:
Christmas Day: event,farm: location,Houses: location,@FOX
PCAs: event,@BTS_twt: product
2021: event,CzechRepublic: location,Prague finishes today
Djokovic: person,@TSN_EDGE: corporation,Djok
@Sam_Seder: person,@Jimmy_Dore: person
New Years Eve: event,Park City,Utah: location,B.S
Brock Boeser: person,Canucks: group,@Sportsnet_
Trump: person,@user Ring of Fire Network: corporation
Reds: group,Braves: group,Marlins: group,1.5
Trump Supporters: group,Trump: person,House Burned Down: event
@Ben_Domenech: person,CDC: corporation,Schools: location,
Scary times , but excited at the prospect of getting back to the office soon .
Red Zone: location,Eagles game: event,Dennis: person
@KENYA_MOORE: person,P . Valley Williams: person,H
20 Years in the Stock Market Could Be the Difference Between $ 0 and $ 630,
SIXERS: group,DOC RIVERS: group,@Philadelphia_
WeRejectPMCBill: corporation,WeRejectNLE: corporation,We
Newt Gingrich: person,Trump: person,TUMP: person,VO
NZ: location,@1News: product
@BTS_twt: corporation,Permission to Dance: creative_work,
Wrestlemania: event,Wrestlemania night 1: event,Urban
dog: person,puppy: person,@YouTube: corporation,dog:
Papa Woof: person,SvenPals: group,Svengoolie:
I See Them: creative_work,@Audiomack: corporation
@Phoenix_Suns: group
@Samsung_Mobile_US: corporation,@Samsung_Elect
Steelers: group,Taylor Fulgham: person,Jerry Rice
JESUS CHRIST: person,@Kanu_Nwankwo
Man In The Sky: creative_work,RoelBeat: person,M
Twitter: corporation,@user: person,Pokemon: product
34 +35 music video part 2: event,@Ariana_Grande:
Armenia: location,Azerbaijani lands: location,Azerbaijani
Dan Crenshaw: person,Trump: person,Trump: person,Trump
PoppyAppeal: creative_work,@Royal_Britis
@Grubhub: corporation
Austrians: group,COVID19: product,Aggelos Sot
Bill Gates: person,Funded Company: corporation,Georgia
Trump: person,Trump: person,Trump: person,Biden: person
New Years Eve: event,@user: person
MINIMAL WARM IS SUCH A NICE SONG TO LISTEN TO IN
Nano: person,WeNano iOS: product,107 payouts: event
CNN: corporation,Trump Supporters: group,@user News: corporation
@BTS_twt: group,BTS: group,Dynamit
The Power of the Myths: event,Policing: event,America:
Booker: person,@LA_Clippers: group
LAFC: group,Galaxy: group
Three Lions: group,@When_Saturday_Comes: event,
@Saint_Louis_FC: corporation,WWCC: event
NBA Summer League: event,LiAngelo Ball: person,@G3
Knox: person,@Sky_Sports_Golf: corporation,@user
New Years Eve Game: event,Piedmont College: location
Apex Lege: product,@YouTube: corporation,@Apex
Coronavirus: event,CGTN America: corporation,@Google_News: product
White sox: group,BATANTLY cheat: group,@New_Yor
Trump: person,Trump: person,Royal: person,Rep.
tysonvsjones: person,@Mike_Tyson:
Let’s Get Real: event,Twitch streamers: group,The Pande
The Good Times And The Bad Ones CD: creative_work,@Why_Don’
@BLACKPINKOFFICIAL: corporation,100MostBeautiful
Poshmark: corporation,Black Lives Matter Necklace: creative_work,@Po
Baekhyun: person,@EXO: corporation
Josh McCown: person,Sam Darnold: person,Texans QB Des
@Alexandria_Ocasio-Cortez: person,@
Da Bear: person,The Seedist: creative_work,The Sadist: person,
Derby: location,@Derbyshire_Live: location,BBC_Radio_
Kristina Morgan: person,KiddieNomics: corporation,Ki
Whosfan: person,Employee: person,treasure:
@Joe_Biden: person,@Kamala_Harri
@Celtic_Football_Club: corporation,@C
Prime Minister Imran Khan: person,NRO: group
Taji amejua kunyonya kidole
AxumMassacre: event,TigrayGenocide: event
ROSÉ: creative_work,100M STREAMS: creative_work,K
1000 Better Stories: creative_work,@user: person,@user: person
Pence: person,Trump: person,Afghan allies: group,Ste
@AJR: group,OneSpectacularNight: event
MMATwitter poll tournament Finale: event,@C_HT_O
physed: group,healthed: group,slowchatpe: group
Eastbound: location,VT: location,Seattle-Tacoma International
PJ Harvey: person,The Wind: creative_work,Is This Desire:
@Luis_Suarez: person,pichichi: event
Phil Hill: person,@user: person,2020 album: event,Through Hell And
The Light in the Darkness: creative_work,@YouTube: corporation,
Thomas Tuchel: person,@NewsNow.co.uk: product
Charm City Kings: group,@Meek_Mill: person
Black Lives Matter Goon Punches Woman Driver in the Face - Another Keys
LVPhantoms: group,WBSPens: group,Tan
58 feet high tricolor: creative_work,Happy Independence Day: event,@S
Jantar Mantar: location,Delhi: location,BJP Yuva Morcha
SOG: group,24-17 WBS: group,15-8 WBS in period:
@user: person,tiptoes: product,stool: product
Dublin Art Book Fair: event,@user: person,Dirkland Art Book Fair
TV reviews Daily: creative_work,@The_Sunday_People: corporation,
kmac2k21: person,Bloodhound: creative_work
EscapefromTarkov: corporation,stream bag: product,@Battlestate_
Jalen Hurts: person,Carson Wentz: person
Euro2020: event,England: location,TV coverage: event
Poshmark: corporation,Strong Africa Black Gold Foil Face Mask Masks: product
@Alanis_King: person,@Jeffrey_Ear
Sunisa_lee: person,Sunisa Lee Day: event,M
Michael Chandler: person,@Michael_Chandler: person
@YouTube: corporation,Halo Infinite Spoilers Out
PalisadesFire: corporation,Firefighters: group,750 acres:
Eagles: group,QB Jalen Hurts: person,QB situation
youtube: corporation,youtuber: corporation,youtubechannel: corporation,Smal
Eritrean troops: group,6th century monastery: location,houses: location
Star Wars Detours: creative_work,George Lucas: person,America's
@Apple_Support: corporation,iOS 14: product,AirPlay:
Super Bowl Predictions-LIVE: event,@YouTube: corporation,
Valentine’s Day: event,@LA_POKER_CLASSIC_2020:
Texas Officials: group,Trump Supporters: group,Biden-Harri
@Dak_Prescott: person,@Dak_Prescott: person
disney: corporation,@Disney_TVA: corporation
HAIKU: person,COVID-19: event,New Year's Eve:
@user: person,online permits renewal: event,@user: person
Games People Play: creative_work,@The_New_York_Review
MamamooWAW: creative_work,@(MAMAMOO)
Venezuela and Cuba: location,Abdala: product,Covid vaccine: product,
Freecloud: creative_work,@Fairfield Inn & Suites San Francisco
@Syed_Talat_Hussain: person,JSI:
ColorsTV: group,BigBoss14: event,beinghuman2020:
King 's Cross station: location,England: location,Fleet
God Save the Queen: creative_work,Level 59: creative_work
New Orleans: location,Hurricane Ida: event,@ABC
@BTS_twt: group,music: creative_work,music: creative
@Nova_Scotia_Power: corporation,small businesses: group,energy
Bill Gates: person,Funded Company: corporation,Genetically Modified
Feliz Da de Los Muertos: person,Day of the Dead:
1637: person,No Peace Beyond the Line 29 Ring of Fire: creative_work,
Biden event in Texas: location,Trump supporters: group,@National_Fr
Next week: event,TV3GH: group,DateRush: product,@
@sonu_sood: person,@SONU_SOOD_FC
Gigi Hadid: person,baby daughter: person,@Metro: product
WrestleMania: event,@Kurt_Angle: person,@
@Chicago_Cubs: group
@Kevin_Durant: person,Nets: group,Harden: person
Dutch Crime Reporter: person,@VICE: product
This Ability Podcast: corporation,@Maria_Lyle: person,presenter:
@Greatest_Hits_Radio: corporation,RockFM2: corporation,60s
Saskay: person,BBNaija Shine Ya Eye: group,Big
Pynk Beta: product,BTCUSD: product,AI: product,Fin
Winter solstice: event,black and white: event
Gators: group
Monterrey: location,@YouTube: product
Thomas Tuchel: person,Chelsea Undropable: creative_work,Man
Champions League: group,Europa League final: event,@Manchester_Uni
@Matt_Kemp: person,World Series: event,Dodger
filo ahgases: group,Philippines: location,t
@Chicago_Bulls: group,@Lonzo_Ball:
Labor Day Weekend: event,Dr. Armond: person,Week of 9 /
ENHYPEN: corporation,BORDER: group,CARNIVAL: event,
US jobs report: event,June: event,@ING_Economics: product
The Conjuring: creative_work,The Conjuring: creative_work,Rock
Fmg Red: product,No More Parties Freestyle: creative_work,@
Thai Enquirer: corporation,@Thai_Enquirer: corporation
@Tavleen_Singh: person,COVID vaccine: product
Argentina: location,@LAFC: corporation,2056: event
Father ’s Day: event,Kemetic Family: group
@Alexey_Navalny: person,Russian cities: location
@Mark_Hanretty: person,@Dancing_on_Ice
Seattle Metro Playoffs / Game 2: event,Avg: person,51
Gray: person,Boak: person,Power: group,Vardy: person
Christ: person,House: location,Silent Listener: person,@E
Sentinel: corporation,DVPNs: product,@user: person,blockchain
ASAPHotMoves: group, ASAPfreshcollab: group
ENGENES EN-TIL THE END: creative_work,@ENHYPEN
Bears: group,@Allen_Robinson_II: person,Rob
Sudney Sauna: location,New Years Eve: event,Sudney Sauna: location
@Los_Angeles_Lakers: group,Super Bowl: event
ILOVEYOUTWO: group,TREASURE: group,@TREASURE
ArnabGoswami: person,deaf: person,mute
@Archive:@Governor_Andrew_Cuomo: person,
ItsASin: group,channel4: group,ollyalexandergrowingup
Attack on Titan Director: person,MAPPA: corporation,WIT Studio: corporation,@
NEWS JUNKIE DAILY: creative_work,@user: person
@Newsmax: corporation
Malcolm X: person,NewWorldOrder: corporation,KlausSchwab
Becca: person,PDCWomensSeries: event,Donna Gl
New Year's Eve: event,artists inc: group,@user:
Philadelphia: group,Game 7: event,Flyers: group
@FC_Barcelona: group,@CAMPONES: group
@shannon_sharpe: person,@nick_wright: person,
Wooster coach Jodie Schumacher: person,@user: person,Woo
@SNY: corporation,Knicks: group,FA: group,Jets
Rayden Solicitors: corporation,Big Bucks and a Long Marriage: event
Dogecoin: product,Webull Crypto: product
@user V: person,Crayford Ko: location,10:30am: event
Creating the Perfect Coastal Look: creative_work,@Trish_Regan
Persian New Year: event,@CNN_Travel: product
Cajun Navy: group,Hurricane Delta: event,@Dan_
@AC_Milan: person,Europe: location,Europe: location,Europe:
PNS Daily Newscast: corporation,Trump supporters: group,Oakland:
Isles: group,OEL: group,Kuemper: group,GoStars
9Baje9Minute: event,5Baje5Minutes:
@RIHO_: person,Maki Itoh: person,AEWD
Permission to Dance: creative_work,@BTS_twt: product
Rangers-Devils: group,Rock: location,Nico Hischier:
GenBank: corporation,@National_Library_of_Medicine: corporation,
EU: corporation,EEU: corporation,@user: person
@Arizona_Coyotes: group
Jenny Lind Vintage Bottle: product,Retsy: product,Labor Day weekend sale
Ohio State: corporation,@Big_Ten_Conference Championship: event,@A
Red Raiders: group,Carries: person,169yds: person,
COVID19: event,@Dr._Ramesh_Pokh
@Washington_Nationals: corporation,hat: product,bad people: group
Bad Boy Blueprint Review: creative_work,Shocking Critical Details Uncovered: creative
Luna: person,@LUNA: person
@ SwaapCrypto: corporation
Saratoga Springs: location,Saratoga Springs: location
Johnson & Johnson: corporation,Pennsylvania: location,6
UFC 265: event,Luque: person,D’arce choke:
@user: person,@user: person,@user: person,@user: person
@DoorDash: corporation,restaurant: corporation,order: product,2 hours:
BFORCE: creative_work,TOGETHER STRONGER BETTER:
@Olivia_Rodrigo: person,Y2K vintage looks
@Manchester_City: corporation,@Manchester_City: corporation,@
Flag to Flag looking likely ! All eyes on the sky Come on @user: person
Good Folks: person,Chess Club team: group
Ethiopia: location,@Samantha_Power: person,@United
Lace is Life My Heart is Kate Spade Teddy Bear Clip: creative_work,@
CamNewton: person,UDFA receivers: group,@Jimmy_
Snapods: group,TWS Earbuds: product,MagSafe:
@Jonathan_Swan: person,@Jonathan_Swan
Honey: person,EastEnders: group
everythingoes: group,New Years Eve 2020: event,@BTS_t
@Charlie: person,Else: person,@Mark: person,1s
ValentinaRossi: person,GOAT: group,@Moto
Green Bay: location,NFLPA: group,Green Bay: location,NFL:
Tropical Storm Sally: event,New Orleans: location,@NOLA.com: product
Mane: person,Salah: person,@Mohamed_S
@Zee_Tamil: person,zeethirai: person,va
MNL 48: group,MYX Daily Top 10: event,@MNL48
Love is like the wind, you ca n’t see it but you can feel it
Kamalas: person,@ SenKamalaHarris: person,
Biden: person,Trump: person,TX: location,@Yah
climatechange: event,EU: corporation,EUA: corporation,@Open_Soc
@AIMIM MP: person,@Imtiaz_Jale
Anchorage: location,JEEP: product
HarleyQuinn: person,The Suicide Squad Character Guide: creative_work,East
Trump: person,Open Championship: event,Scottish golf club: location,@Y
Hoima City: location,@Umeme_Limited: product
Bears: group,Twitch Affiliate: corporation,smallstreamer: group,S
49ers: group,AZCardinals: group,@Adam_Sche
@CU_Boulder Engineering seniors: group,@CU_Boulder Engineering:
@Luke_Combs_: person,Forever After All: creative
Vitamins from direct sun: product,@user: person,@Kota Se
@San_Francisco_49ers: group
Middle East: location,@McKinsey_&_Company
Cay Burton: person,Autism spectrum disorders: group,ASDs
@user: person
Thanksgiving: event,USA: location,@user: person
Sun Rise: creative_work,@Picfair: product
Zoom conference: event,Isloch Artyom Radkov: person,Bre
Richmond: location,Rotimi_Segun: person,Sarries:
@Stephen_Curry: person,Babyface Assassin: creative_
Smallpox: person,WorldPolioDay: event,@Rot
@Mace: location,Dr Marzia Bolpagni: person,@R
copy: product,@TREASURE: product
SonomaNats Funny Car E3 results: event,@Ron_C
@News12LI: corporation,Hydro Supt: person,
@Harry_Styles: person,Treat People WIth Kindness: creative
50 Years of the Fight against the Illicit Trafficking of Cultural Goods: creative_
@Fantasy_Premier_League: corporation
Fiji Blue: person,It Takes Two: creative_work,@user:
Trump: person,Royal: group,White House: location,@Ya
Cancer Survivor: person,@Jennifer_Sertl_#
Errol Spence: person,@Terence_Crawford: person,@
Fast Chargers: product,@Arun_Maini: person,@App
URL: person,The View: corporation,Megan Stalter: person
@JL_Bourg_Basket: person,7DAYSEuroCup
qiu danfeng: person,iqiyi: person,
Disinformation threatens our democracy . This election cycle: event,@PEN_America:
@SHYGIRL: person,@SHYGIRL: person,music: creative
@ANI: corporation,David Saker: person,Jim Laker: person
MarlosMarvelousFinds: product,EtsyShop: corporation,
Top 10 song lyrics: creative_work,@Daveed_Digg
Labor Day weekend: event,@Ai-jen_Poo: person,
Teardrop Inkigayo: person,stage: event,@SF9official
@Davido: person,KING: person
@DJ_TUNEZ: person,@Wizkid: person,
Heat: group,Celtic: group,@Boston_Cel
@user: person,The Seagull: location,production: event
Atlanta Activist: person,Black Lives Matter: event,FBI: corporation,
HD7: location,engineers: group,12:50am: time
Trump: person,America: group,America: group,America: group,America: group
Baby Boom: creative_work,@Jon_Lovett: person,Em
New Years Eve Miracle Worship Service: event,@facebookwatch: product
Seattle: location,@The_Seattle_Times: product
Afghanistan: location,@President_of_Russia: person
reload: creative_work,@user: person,Jaewynn:
Armenia: organization,@UEFA: corporation
@YouTube: corporation,O.F.M: creative_work,D
Elton John: person,Friends: event,@YouTube: corporation,
@Eric_Trump: person,@Donald_Trump_Jr
@Netflix: corporation,@HerEyes: group,The Skeleton Key
Trump: person,Tiny Dancer: creative_work,@Elton_John
Jalen Hurts: person,Ashon Jeffery: person,J
Donny: person,Belle: person,@Donny: person
Everton: group,Nufc: group,@Allan_Saint-Max
@Wonder_Woman_1984: group,star-shaped foil balloon
@Kalonzo_Musyoka: person,Kenya:
Kermit: person,@Elisa_Jordana: person,@and
Esencia Animal: corporation,lora: location,Esencia Animal:
Ohio State: corporation,B1GCchampionship: event,Oklahoma:
@Bill_Landis: person,Ohio State: corporation,CFP
@Gears_of_War 1: group,RAAM: person,GEARS
Nest raider: person,glass cabinets: product,@Daily_Mail_Online
cricket: event,1 day cricket: event,2 days hangover: event
@midnight_sun_: person,Fuji 5000: product
@user: person,battle: event,@user: person,3rd
Hard Work No Labor Intro: creative_work,@DistroKid:
@Joe_Biden: person,cancer: person,ACA: group
@Dion_Dawkins: person,@Josh_All
strong: person,Black Lives Matter Movement: event,@user: person
DaleHouseCafe: location,Historic Jamestowne: location
Russell Westbrook: person,@Los_Angeles_Lakers: group
H & M Girls Skinny Fit White Pants Size 11-12 NWT: corporation
QuestionOfTheDay: event,MagnumPI: product,perfectionism: creative_
Leo: person,Bros: group,Today: event,Dad:
@Corbin_Middlemas: person,@Ben_Cameron
Teume: group,@TREASURE: group
KCAMexico: location,BTS: product,Butter: product,@BT
Votings: event,BKPP: corporation,VoteForKh
MORGAN WALLEN: person,@morgan_wallen: person
Wrestlemania Night 1: event,Bunny army: person,@B
@Ormax_Media: corporation,@Rubina_Dilaik:
@Canara_Bank: corporation
Bucks: group,Picks: group,@NBA_Official:
EragonRemake: creative_work,@Disney: corporation,@D
Love in This Club: creative_work,Pt . II: creative_work,
Consequences: creative_work,Tory: corporation,@Mat
@San_Diego_Padres: group,PresidentsCup:
Book # 24: event,The Bad Seed: creative_work,MyBookPledge:
Tadesse Werede: person,Tigray Defense Forces: group,
Disney Staycation: event,River Resort Deluxe Studio Tour: location,Ep
trump supporters: group,NBC: corporation,Nov 3: event,Nov
Kenyans: group,Italian: group,@Prof_Makau
The Secrets of Montrésor: creative_work,The French Orphan: creative_
Wonder Woman: creative_work,@Gal_Gadot: person,
Here ’s How To Actually Keep Your New Year ’s Resolutions In 2021
Rotor: person,Valentines: event,free teddy bear:
@The_Guardian: corporation,Andrews Air Force Base: location,
Problem films: creative_work,@Dave_Karger: person,@
@Jordan_Spieth: person,@PGA_TOUR: event
@Christina_Aguilera: person,FallOnMe: creative
MelOn: corporation,MelOn Realtime: product,MelOn 24
Trump Administration: corporation,Middle East: location,Israel: location,@The_
@Joe_Biden: person,@Kamala_Harri
Trump: person,@user: person,Trump: person,vote counting:
@Grambling_State_Univ: corporation,@GramFam
DaBaby: person,Rolling Loud: event,@Page_S
Gregorian chants: creative_work,@Bodleian_
World Summit for Noble Peace Laureates: event,Global Black Lives Matter Movement: group
Happy Anniversary beautéderm and more years ! #BD12thAnniversary:
King and Queen: person,Spade: product,Clover: product
Japan Top 100: event,BTS: group,@BTS_twt:
@NBA: corporation,@NBA: corporation
Nigerian American: person,@Halima_Gikandi: person
@Nike: corporation,Nas X: product,child labor: product
Walsh: person,Ponga 2.0: product,Warriors: group,B
Sum 41: person,Over My Head: creative_work,Better Off Dead: creative
Trump: person,Trump supporters: group,vote counting: event,all votes
Parents: group,@user: person,Xtraordinary People: group,Kate G
BAGGAGE: product
Biden: person,Social Security Administration: corporation,@Yahoo:
@Granger_Smith: person,Merica: person,Truck: product,
Albuquerque: location,@Yahoo: product
New Years Eve & Day stream: event,@user: person,@user: person
Daunte Wright: person,Brooklyn Center: location,MN:
YFN Lucci: person,Rick Ross: person,@Yung_R
@Alabama_Men’s_Basketball: group,SEC
Leadership is not a title, it ’s a behavior @user & @
America: location,@The_New_York_Times: corporation,@
Genshin: location,@Genshin_Impact: product
@Bravo: person
@Buffalo_Bills: group,4th Down: event
Submissions Close Wed 17th so please sign this easy template You can add that Lend
Giants: group,Jets: group,Bears: group,Takea
Beauvillier: person,Flyers season: event,4-0 NYI: event,
Lighthouse Hockey: corporation,Eastern Conference Finals: event,Flyers series
Massachusetts Bar: corporation,JoeOteri: person,Suffolk
Philadelphia: location,White House: location,@Financial_Times: product
Cobalt Soul: creative_work,@Matthew_Mercer: person
@Twitter: corporation,@Twitter_Support: corporation,American
Tampa Bay: corporation,Dallas: location,NBC: corporation,Santa
Stanford: corporation,@David_Shaw: person
@Dallas_Stars: group,Santa Clara Cup Final:
@Denver_Nuggets: group,Lokers: group,western
@UNESCO__#Education_#Sciences_#Culture
Ed: person,Lorraine: person,The Conjuring: creative_work
Esper: person,historic meta: event,@user: person,97% mythic
New York City: location,COVID-19: event,Da de los Mu
@Boston_Bruins: group,@TD_Garden: location
@BBC_Strictly_: group,@SCD_Band
hotel quarantine: event,mother: person,hotel: location,@President_of
Lakers: group,WWCC: group,Leeds: group,@L
Biden: person,Trump: person,Pennsylvania:
@Snoop_Dogg: person,losing friends: person
Lamps: product,UK: location,UK: location,@Boris_John
Manchester_United: group,@Manchester_United: group
Hillbilly Elegy: creative_work,@Ron_Howard: person
@Errol_Louis: person,leroy: person,Mr.: person,
Gulf: group,@gulfkanawut: group
Apple: product,iPadOS: product,iPadOS: product,macOS Big
Carly: person,Erin: person,@Carly_Incontro: person,
Peabo Bryson: person,@TIDAL: corporation
Super Bowl halftime show: event,@Yahoo: product
Emma: person,LV Rams: corporation,Super Bowl: event,F'N Don
MorningBliss: person,ThanksgivingSunday: event,NP Holy
Valentine’s Day: event,@Bill_Gates: person,@valentines
@Robinhood: person
Trump supporters: group,@NBC_News: product,Trump: person,O
@Travel_-_State_Dept: corporation,@Secretary
Chiefs: group,SuperBowl: event,Tyreek Hill: person
@Cyril_Ramaphosa__#Vot
Aircon: product,company: group
@Matt_Mosley: person,@user: person
FBI: corporation,Trump: person,Biden: person,@CBS_
@NASCAR: corporation,@Joe_Gibbs_R
Manchester is Red: group,@Manchester_United: group,MCIMUN
Texans: group,@Texas_Tribune: corporation,@De
MusicalMood: creative_work,Sun Construct: creative_work,Ph
West Ham: group,Man City: group,FA Cup Final: event,Premier
Trump: person,Biden: person,Honking and Heckling: creative_
Blowin: person,Peter: person,Paul: person,Mary: person
New Zealand PM: person,@Jacinda_Ardern: person,
Jaehyuk: person,Treasure: person,Chow Chow:
Poshmark: corporation,Striped Crop Top: product
Samuel 15-16 NIV: event,Saul: person,Saul: person
Mexico: location,Day of the Dead: event,@ABC_News: product
Arena Alliance: group,@Dallas_Stars: group,@Tamp
Pennsylvania Democrats: group,Rios: group,Pennsylvani
cryptolibradefi: corporation,libra: product,bnb: corporation
Holy Week: event,PALM SUNDAY OF THE LORD'S PASSION:
@David_Schoenfield: person,Blake Snell: person,
Sparking Outrage: event,lilnasX Limited Edition Nike: product,
Lucas Vazquez: person,Real Madrid: corporation,Aaron Wan
@Muhammadu_Buhari: person,Banditry & Kid
the view from up here: creative_work,@CBC_Music: corporation,nationalice
Ralph S. Northam: person,Matthew Rushin: person,aut
TDataScience: corporation,Graph mining: product,Twitter: corporation
Democrats: group,@Glenn_Greenwald: person
President Trump: person,joe Biden: person,@Department_of_
Hip-Hop Boombox Teddy Bear T-Shirt Urban Picasso Art URL via
Politics: creative_work,@Pope_Francis: person
AxumMassacre: event,TigrayGenocide: event
Mark Sears: person,OHIO: corporation,Ball State: corporation,64
@user: person,Sheikh: person,Jarrah: person,SavePales
Trump: person,@Jim_Carrey: person
@Harry_Styles: person,TreatPeopleWithKindness:
VoteIceCream: creative_work,KCA: location,@
MapOfTheSoulOne: creative_work,D2: creative_work
Shawn Mendes: person,WONDER: person,Wax Strip: creative
@Shehnaaz_Gill: person,APKA SWAGAT H
cancelnike: person,@Nike: person,@MONTERO_ sneakers
PortStephens: location,Panddocks: location,Nelson Bay
@When_We_All_Vote: group
@Cerys_Matthews: person,30 Days of the Dead:
Mother: creative_work,@Julia_Louis-Dreyfus
Victoria: person,America: location,UK: location,Europe: location,@Dan
Valentine’s Day: event,@Future_Islands: group,@
Pilots: group,@user: person
@Nancy_Pelosi: person,@Kevin_McCar
Secret Service: corporation,MSM: corporation,@user: person
@Kane_Brown: person
Patriots: group,build your following: group,drop your handles: group,follow back
Coronavirus: event,@The_Blaze: corporation
Dustin: person,UFC257: event,Disney: corporation
50 proof: event,eaJ: person,alcohol: product,Christian channel
@On_Air_Romeo: person,@Most_Requested_
Kansas City quarterback Patrick Mahomes: person,Kansas City: location,T
ProblemSolvers Caucus: group,@Rep._Dean_Phil
NowPlaying: event,Lil Wayne: person,@Imagine_Dragon
Italian cable car plunges to the ground, killing at least 13 people
@user: person,@user: person,@user: person
Petition for @user to cover Stay by the Kid LAROI and Justin Bieber
@VLAD: corporation,@CNBC: corporation,13 securities: product,@
@a-ha: person,TakeOnMe: creative_work,VMA:
Treveyon Henderson: person,Oklahoma State: location,@Tre
BoomerSooner: person
@GOP: corporation,Black Lives Matter: group,Lafayette Square
President elect: person,@Joe_Biden: person,@Ka
@England fans: group,@England: group,@Naz
@Olivia_Rodrigo: person,UK: location,@
Latino Trump supporters protest in Miami: location,@Yahoo: product
Trump supporters: group,Philly: location,Progressive protesters: group,@
Big Bens: corporation,Super Bowl: event,Santonio Holmes: person
Trump admin: person,human rights groups: group,@NBC_News: corporation
@Joe_Biden: person,debate: event,@J
Toronto: location,BringBackMVP: product
bright: person,olive rodrigo: person
Sully Strictly Butter: person,Sliding: creative_work,S
August: event,@user: person,@user: person,STATE CHAMPS
Burning Sands: creative_work,@Tosin_Cole: person,
Baylor: group,Bears: group,D.C.: person
Liverpool Plains: location,Coonamble: group,Hunter pipeline: product,
Drew 's: event,LaKeithStanfield: person,
NCAA: corporation,UMass Women's Tennis: event,The NCAA: corporation,@
England: group,Hrvai: group,Fifa World Cup 2018: event
@European_Commission_: corporation,Facebook News: corporation,UK
Anees Farooqi: person,@Sidharth_
Babyyyyyyyy: person,@Viola_Davis:
mom: person,mothers day: event
Peter Madana, Saheer: person,UNFLTRD Podcast: event,
Voter suppression: event,Social justice: event,@Amy_Lee:
NFL: corporation,@Houston_Texans: group,Watson's
Brincando de The Walking Dead: creative_work,7 Days to Die:
L2 Rollup: creative_work,@Polygon_|_$MATIC
The Suicide Squad: creative_work,@The_Suicide_Squad
BC Coroners Service: corporation,Province: group,Ambulance:
@Hendrick_Motorsports: corporation,@user: group,He
@New_Jersey: corporation,@Walmart: corporation,@
GME stock situation: event,@The_White_House: corporation
Valentines Day: event,@user: person,@user: person,house: location
@BTS_twt: group
Lakers: group,clippers: group,And Cowboys: group,@s
Amy Coney Barrett: person,SCOTUS confirmation: event,@user: person,
delivery service: product,@Sunday_Times: product
Wizard of Legend: creative_work,Hurricane Force: creative_work,
@Keith_Brown: person,HrH: corporation
@Babajide_Sanwo-Olu: person,@B
@user: person,Trance: person,VictoriaDinaire: person
@Arsenio_Hall: person,Coming2America: event
Let Me Blow Ya Mind: creative_work,@Gwen_Stefani
@user: person,@motorcity: location
The Weeknd: corporation,Louis Tomlinson: person,@Louis_Tom
Sunday special: event,@user: person,0245457999: person,w
Spice, Sean Paul, Shaggy: person,Go Down Deh: creative_work,
@Boris_Johnson: person,@Boris_Johnson: person
Jacks: group,Rockets: group,8-2: event,Score
Tropical Storm Ulysses Typhoon Vamco Philippines: event,@YouT
Merry Christmas everyone: person,New Year: event
Tucker Carlson: person,@Palmer_Report: product
Julio Jones: person,Titans: group
@user: person,subathon: event,@user: person
@The_New_York_Times: corporation,Ross Dou
@mayor_of_jackpot_city: person
Dr. Sajjid Chinoy: person,@user: person,
cancelboardexams2021: event,@Mamata_Baner
stream tonight: event,OBS: corporation,settings: product,microphone: product
Bill Gates: person,ex-girlfriend: person,@Yahoo
Red Carpet: location,@ENHYPEN_OFFICIAL: product
@Bruce_Buffer: person,UFC259live: event,@UF
Northeast: location,@Alarm_Will_Sound: person,@user
Germany: location,Pandemic: group,@Melissa_
Sleepless: creative_work,Daily Insanity: corporation,Da
Amanda Priestly: person,@Waylon_Lewis_&_Ele
firekeepersdaughter: group,firekeepersdaughter: group,fire
Poshmark: corporation,Steve: person,Barry: person,Ohio
Bank of England: corporation,e-pounds: product,Cash dies out:
TSA: corporation,Labor Day Weekend: event,Fintech Zoom: product
Manchester_City: corporation,@Arsenal: corporation,Invinc
Team USA: group,Tokyo: location,Gold Medal: event,@The_
Steelers: group,Colts: group,Steelers: group,Col
Trump: person,Trump: person,First Debate: event,@Yah
Life is Strange: event,before the storm: event,game: event,@user:
@J._Cole: person,@BobbyBullet: person
Nets: group,SOS: group,6ers: group,Bucks:
@Olivia_Rodrigo: person,US: location,US
Charm City Kings: group,@Meek_Mill: person
Morissette: person,MusicXFanMeet: person,A
@Arizona_Soccer: corporation,Grace Santos: person
@Eric_Bischoff: person,WWF: corporation
@user teams: group,SCAC Championships: event,2020-21 campaign: event,
Alex Marshall: person,A Crown of Cold Silver: creative_work,Alex Marshall: person
Saturday Sweepstakes: event,@Kellogg's: product
CBIFindAjitabh: person,Ajitabh: person
Jazz: group,Warriors: group,@Georges_Niang:
Man Stabbed: person,San Francisco: location
Alison: person,@QandA: product
The Devil Wears Prada: creative_work,The Film: creative_work,@
New Zealand: location,@americascup: product,New Zealand: location,New Zealand
@user: person,banana: product,$23: product
ShoutoutSunday: event,SweatyMob Spotlight
@Georges_St-Pierre: person,@danawhite: person,George
@Los_Angeles_Dodgers: group,World Series:
SouthAfricaBurning: event,@SABC: corporation,tv: corporation
King Kev: person,@user: person,NUFC: location
Literary Hitchhike: event,Henley: location,Fair Mile: location
How To Be The Voice And Not The Echo: creative_work,@user: person,
AxumMassacre: event,TigrayGenocide: event
@Walt_Disney_World: corporation,flag retreat ceremony: event,
Zip up: product,hoodies: product
EricaFernandes: person,stars: group,stars:
@Full_Fact: corporation,Christmas: event
Sunshine On Leith: creative_work,@The_Proclaimers: group
Christian Horner: person,Toto Wolf: person,Red Bull: group,M
NBAFinals: event,POTUS45: event,BBall: person,
Luxembourg: location,@Visit_Luxembourg: product
@Theta_Network: corporation
Tigray: location,Eritrea: location,Ethiopia: location,@
@Twitter_Safety: corporation,Andy Ngo: person,in
Charles Oliveira: person,Michael Chandler: person,UFC
Jens Weidmann: person,@Deutsche_Bundesbank: corporation
Lordiversity: creative_work,Lordiversity: creative_work
@Ensia: corporation,@FoodEnvReportingNet: corporation
Andrea Mallis: person,Astrologer: person,Get Dental Implant: product,
Raksha Bandhan Akka: person,@Danasari_A
Sweet 16: event,@Syracuse_Men’s_Basketball
Covid cases: group,South Carolina: location,@Gov._Henry
Pep Guardiola: person,Ilkay Gundogan: person,@Manchester
The Good Times and The Bad Ones: creative_work,@Why_Don’t
@Joe_Biden: person,@Joe_Biden
Wolverines: group,Endangered species: group,@Change_
Easter: event,Easter: event,9am: time,11am: time
@Kiana_Ledé: person,@Kehlani: person,@
@Stray_Kids: group,MTV EMA: group,
The Guys: group,EVIL DEAD 2: creative_work,ARMY OF D
Captain Chesley ‘ Sully’ Sullenberger ’s scathing anti
Sarkodie: person,Loyd sarknatives: group
Missouri: location,Mossipes: location,@HuffPost_
Murphy Bed: creative_work,Murphy Bed: creative_work,Murphy
@user: person,America 2: event,@user: person
Utahns: group,@Gary_R._Herbert: person,@
Ohio State: corporation,Big10 Leadership: group,Ohio State: corporation,@
Crabby Joe: corporation,organic chem test: creative_work,Crab
SaiDharamTej: person,DevaKatta: creative_work
Okudah: person,Davante Adams: person,Deandre Hopkins
ATL: corporation,New Years: event,LETS GO: event
Garrison Starr: person,Growing Up Gay in Evangelical Church: creative
Sakyong Mipham: person,Timeless: product
Father ’s Day: event,kings: group,@user: person
Pfizer: corporation,@ORF: corporation
Dr: person,@Richard_Dawkins: person,Dream
@Los_Angeles_Dodgers: group,World Series:
Pakistani actresses: group,@Bisha_K._Ali
Alec: person,Alec: person,limitlessFortune: product
SportsHeadlines: corporation,@NFL: corporation,Sean: person
KEEMSTAR: person,Xbox series S: product,PS5: product
Foxtail: location,Winter Park: location
GetWellSoonYoongi: person,@BTS_twt:
Chindit Etonian: person,@Newmarket_Racecourse: product
ExploreBandung: person,Mercusuar Cafe & Resto: location
Happy Anniversary ! ( Had to Repost a Clean Version ) Song : Where
Joseph Robinette Biden Jr: person,Joe Robinette Biden: person,
Maserati Remix: creative_work,@Olakira_: person
@user: person,GenshinImpact: product,eula: product
Demon Slayer: person,Kimetsu No Yaiba: person
Pink: product, geometrical print: product,reusable and washable: product,
@Mike_Pence: person,25th amendment: creative_work,declass
TzuVoters: group,TWICE: product
Rakhi2021: event,HappyRakshaBandhan: event,Happy
Kane hattrick: person,@Fantasy_Premier
Kenya: location,UK: location,@UK_in_Kenya_
@Planned_Parenthood: corporation,birth control +care: product,
Storm 37 Panther 10: event,Storm: group,Panther: group
@Freddy_Gray: person,Trump: person,Rainbow
FLORIDA LSU: group,OHIO STATE: location,LSU: group
Stephen O'Keefe: person,Paul McGrath: person,G
@DoPT: corporation,@_,_HMO_India: corporation,
Nick Robbins: person,@Elon_Musk: person
Spotify: product,Versatile Ideas IV: creative_work,@Distro
Bill Gates: person,@Entrepreneur: person,@Entrepre
@GregGutfeld: person,limerickolympics:
@Narendra_Modi: person,India: location,Mother land: location
@Anita_Baker: person,Masters: event
Arsenal: group,Ozil: person,@Mikel_Arteta
@Corpse_Husband: group,@Corpse_Hu
Power outage: event,COVID-19: event,SoCal beaches: location,
SweetIce: product,Female: person,rapper: person,Swe
@TD_Garden: corporation
The Suicide Squad: creative_work,@user Woot Woot: person
Shawn Mendes: person,bigtimeradio: product,Amazon Echo:
WWE WrestleMania Night 1 Kickoff April 10 , 2021: event,
@McKinsey_&_Company Quarterly: corporation
COAST GUARD MUG AIR STATION CAPE COD MASSACHUSE
Bank Delays: event,@user: person,HuffPost: corporation
@Novak_Djokovic: person,FrenchOpen: event,
Christmas: event,God: person,Christmas: event,God: person,
@Bill_Maher: person,@Real_Time_with_B
Women 's college basketball: event,@Sharla_McBride
La Caada Flintridge: location,@SCE: product
ScottMorrison: person,victims: group,auspol: product
@Cincinnati_Bengals: group,Burrow: group,
Ethiopia: location,@Abiy_Ahmed_Ali_:
@YouTube: corporation,@YouTube: corporation,Mae
T.S .: person,Live From The Couch: creative_work,Of
When the Sky Falls: event,@user: person,@user: person,@user
@Newsmax: corporation,New Years Eve special: event
Eiiiiii e check like the guys rather they give yawa 
Glasgow: location,Ayr and Dumfries: location,LifeAtS
PA: group,Trump: group,@Breitbart_News:
@Con_Edison: person,@Mayor_Bill_de_
Michael Chandler: person,@UFC: corporation,boxing: event,UFC26
2021 Stanley Cup Final Preview: event,Canadiens: group,Lightn
@twenty_one_pilots: group
Assassin ’s Creed Origins XBOX One Gameplay: creative
Kennedy: person,Parker: person,Swans: group,Aretha
@Lenny_Henry: person,Sir Len: person
Charouz Racing System: product,FIA F3: event,Red Bull Ring
@Atlanta_Braves: group,@Atlanta_Bra
Jefferson Parish leaders: group,Tropical Storm Sally: event,@WWL_
Seaside Heights boardwalk: location,Labor Day weekend: event,US: location
Vercrashing: person,@Red_Bull_Racing_Hond
@HYBE_OFFICIAL: group,@BIGHIT_MUSIC: group
ASAP: corporation,@BGYO_PH: product
Bill Murry: person,Lead role: event
Hold the Line: creative_work,Toto: person,@YouTube:
Evil Leftists: group,Trumpers: group,@Breitbart
Engenes: person,MAMA SHOW: event,Tag: ENHYPEN
FDA and CDC: corporation,J & J vaccine: product,6 women develop blood
ACT: corporation,Lanyon: location
Lockdown: event,Localised: event,Local authorities: group,
360fail: corporation,@NBC_News: corporation,@Nike:
country club: group,covid super spreader party: event,Trump: person,
Crime in the City: creative_work,The Culture Before the Vultures Throw Back T
Carrie Underwood: person,John Legend: person,Hallelujah: creative
Charles Oliveira: person,Michael Chandler: person,UFC
Manchester: group,Red: group,United: group,@Manchester_
Cinnamon buns or coffee to stay, to go, or delivery via @user:
Happy New Years Eve: event,bardigang: person,@iamcardib:
Wallace the Brave: person,November 15, 2020: event,@GoComics: product
Pokemon Harmony: creative_work,@user: person,Bring the hype team:
Iowa: group,@Central_Michigan_WBB: group
Chicago 7: event,@Sacha_Baron_Cohen: person,A
Tokyo2020: event,IOC Boxing Task Force: group,@AIBA: group
@Electrify_America: corporation,charging network: product,software system design:
@Liberty_Football: corporation,@BYU_
@Sky_Sports: group,Flintoff: person,orphan
MORISSETTE: creative_work,@user: person,LYS: product
Bill Gates: person,Xanadu 2.0: creative_work
Drop another episode of the guys before I get mad @DRUSKI
Francis Ngannou: person,Ciryl Gane: person,UFC 265
Trump: person,Trump: person,TrumpvsBiden: person,
Colorado_Department_of_Public_Health_&_Environment:
Cena: person,@Pat_McAfee: person
NASCAR: event,@William_Byron: person,Top three:
Morissette 2.0: creative_work,MORISSETTE: creative_work,
Anthony Fauci: person,CDC: corporation,coonavirus: group,@H
Murphy: person,Blues: group,Redman: person,@user: person
Taiwan: location,China: location,Biden administration: person,@Apple:
ARASHI: person,Kaito Party Starters: group
Drew Brees: person,@Drew_Brees: person,
@James_Campbell: person,New Corp: corporation,North Korean newsread
Morgan Wallen: person,Royal career: event,@Yaho
@Cardano_Community: corporation,@Voyager: person,
Spotify: product,HELLO WORLD: creative_work,@DistroK
Mike Zunino: person,World Series: event,@Tampa_B
Dynamite: person,BestMusicVideo: event,@BTS_twt
Balochistan: location,@Mohsin_Dawar: person
Mother’s Day: event,@user: person,Mother’s Day: event
England: group,Lordship Lane: location,@Circleboom
IRS: corporation,YahooFinance: corporation,Transportation:
Guilty: creative_work,@user: person,ShraddhaA
Rohit Sharma: person,Batchman: person,India: location,@Ro
Marino Ma rinGo K: event,Wil_Eve: person,
@mewsuppasit: product,MewSuppasit: product
Gray Fox: person,@user: person,Growly Fox: person,hom
@Craig_Groeschel: person,@lifechurch: corporation
Dua Lipa: person,Rolling Loud: event,@YouTube
@Marvel_Entertainment: corporation,@Marvel_Enter
Wisconsin Supreme Court Judge: person,Trump Attorney: person,Phony Lawsuit
Alabama Crimson Tide: event,Clemson Tigers: group,Oh
Johnson & Johnson: corporation,COVID: product,blood clots:
@Chuck_Todd: person,@Ron_Johnson: person,
Celtics: group,S Spurs: group,San Antonio: location,San
The D  ark S  ide of the Mo  o 
@Los_Angeles_Dodgers: group,World Series:
Prisons, rehabs and hotels: group,STRUCTURAL: person,@C
@Jordan_Spieth: person,The Open: event
@user: person,@user: person
@Bro._Eddie_C._Villanueva: person,
@Boris_Johnson: person,Vaccine Passports: product,@
@Listia: corporation,@Listia: corporation,@Listia:
WHATDANCEWith AConASAP: creative_work,ACBxGaryV
COVID: event,Cyanide: substance,Covidide: product,
@pablo: person,SLMT: group,SB19_Official
frozen 2: creative_work,Frozen 2: creative_work,@SCAT
Easter: event,@user: person
SRW Impact: creative_work,Rachance Out to the Sky Someday:
@Brian_Babin: person,IllegalImmigration: event
Sky News: corporation,@FYI_TV: corporation,@Sky_New
Chelsea: group,Manchester City: group,Chelsea: group,Che
Trump supporters: group,Detroit: location,@Daily_Mail_Online
Back2BasicsShow: event,New Music: event,@Andra
Joint leaders yet the battle for qualification will be tight . Tenth place is 0.93 back
ExternalyPaidPuppets: creative_work
@The_Week_with_Joshua_Johnson: person,J
Pep Guardiola: person,PSG: group,Advances: event,Man
Covet: product,Sea Dragon: creative_work,@YouTu
IRAN: person,Biden: person,@user: person
Professor: person,@Daily_Mail_Online: corporation
Virtual Open House: event,LLB opportunities: event,JGLS: location
CreditUnion: corporation,UnsecuredLoan: product,HomeEquityL
SF9: corporation,@SF9official: corporation
DEVIL'S JOURNAL VOLUME SIX: creative_work
@Adam_Grant: person,originals: creative_work,@Adam
Julia: person,Joe: person,@FOX_&_friends:
@Delhi_Capitals: corporation,super over match: event,super
@user: person,90days: event,Daughter: person,Spoo
@Tropicana: person,watermelon: creative_work,@T
WeBilib: corporation,DarrenEspanto: person,YFSFBi
WeWantRraHelMusicVideo: creative_work,WeWantR
Alex Marquez: person,MotoGP: event,SpanishGP: event
@Boris_Johnson: person,@UK_Prime_Minister:
Joy Lowe: person,@user: person,@user: person
Siddique Jan: person,Pseudo Liberals: group,
JEREMY ConnectOnASAP: product
Rhode Island mom: person,@The_Daily_Signal: product
@Los_Angeles_Lakers: group, Clippers: group,
ROSÉ INKIGAYO DEBUT STAGE: event,ROSÉ
Neyland: person,University of Tennessee: location,Neyland Stadium: location,
Animals: creative_work,@Roger_Waters: person
British adults: group,@Bloomberg_Markets: product
WrestleMania: event,@Adam_(Edge)_Co
@NHL: group,@Boston_Bruins: group,@New_
Voting Contest-Who is The Queen of Kpop 2021 | - URL
Stan twt: person,MAMAMOO: person,Stan:
@Arrowhead_Pride: product
Female Led Comic Book Movies & TV | The Good and The Bad | Stream
West Ham: group,@West_Ham_United: group,@Don
COAST GUARD MUG: product,US: corporation,ARMY ALLISON
God: person,God: person,Life: event,Life: event,Life:
@Sidharth_Shukla: person,@Shehnaa
Rick-overy: person,@Rick_Kelsey: person,D
iKONIC: group,teume: group,stan account: group,
Economic output in the 19-nation euro area fell less than initially reported at the start of
Munich: location,door size: size,door size: size
Election: event,Nevada: location,AZ-SEN: location,Mark Kelly:
Balloons: creative_work,teddy bear: creative_work,e
Rosé: group,@BLACKPINKOFFICIAL ROSÉ: group,
blues: group,shop shift: event,@user: person,pizza:
@user: person,@JeREMY: person,OnIwant: person,
Martinstown 2nd XI: group,@user: person
Music Matters Year 2020 Tj Music: creative_work,@user: person
BBC Paramedics: group,@Scottish_Ambulance: corporation,
Apostle Suleman: person,@Apst_Johnson_Sule
@Triptii_Dimri: person,RanbirKapo
Riyad Mahrez: person,Manchester City: location,Chelsea
Eng sub: creative_work,KAI: corporation,KAI: corporation,KAI
@Roman_Reigns: person,@John_Cena: person,T
Rondale Moore: person,Chiefs: group,Rondale Moore:
UK Singles Chart: event,@Olivia_Rodrigo:
@errol_barnett_•_cbs: person,mother: person,
WorldChampionships Speedskating: event,Norway: location,
Chindit: person,@Newmarket_Racecourse: location,@Greenham
NFC Championship: event,Packers: group,@Seattle_Se
@B_L_O_S_S_O_M_S: corporation
Peak 2020: event,Pelosi: person,San Francisco: location,@
NP: group,nightshotpromo: event,@user: person,50
The Fear of The Lord: creative_work,@Logos_Bible_Software
Valorant: person,Streak on the Line: creative_work,Game-
The Greatest Gift You Can Give This Christmas: creative_work
Lady Bruins: group,Queen City: group,Mtscores:
Iran: location,Zam: person,EU: corporation
Power Book II: creative_work,FiveFlames: creative_work,Power
Zaya Wade: person,@MONTERO_: group,Baby
Red Sox: group,@Don_Orsillo: person
Keyshia: person,Ashanti: person,Venture: event,
Anthony Taylor: person,Simon Kjaer: person,DENFIN: event,
Twibbon: product
Emergency Weather Warning: event,@GB_News: corporation,Great Britain: location,
VOLT: group,@user: person,@user: person
Full Out: event,PoPinoy2ndElimsNight:
@Ventura_County_Fire: corporation,@Ventura_Count
Biden: person,@Yahoo_News: product,antif
Tucker Carlson: person,@Palmer_Report: product
England fan: person,@BBC_Radio_5_Live: corporation,It
HYLT: group,LSG: location,Light Up The Sky: event,
Move: event,MTVMIAW: group,MTVLAKPOPBTS:
ArrearsforRRBs: group,@DFS: corporation,@N
@Mark_Tuan: person,@Mark_Tuan: person,@
Corin: person,Pride Lands: location,@user: person
White toxicity and racism: group,Asians: group,AAPIHeritage
Top Social 50: event,@BTS_twt: product
Maa Taratarini Yatra: event,@CMO_Odish
Risk of Rain: creative_work,1.0 update: event,Acrid: person,
The Sky: creative_work,stars Daily: creative_work,@user: person
UFC259live: event,@Israel_Adesanya: person
Poetry: creative_work,Super Bowl: event,@Amber_Jamieson
@user: person,choi yena: person,yenaaco
God Save the Queen: creative_work,Level 4: creative_work
Nike: corporation,Lil Nas: person,Satan Shoes: creative_work,
Whendonverse: group,@Joss_Whedon: person,The
Ethiopia: country,Ethiopia: group,Ethiopia: group,Ethiopia
NASCAR Cup Series: event,Daytona: location,road course: location
Resources in the Fight Against Police Brutality and Systemic Racism:
White House: corporation,low-income people: group,minorities: group,@
The Conjuring: creative_work,The Devil Made Me Do It: creative_work
@Senator_Pat_Toomey: person,@Richard_
Poirier: person,Conor McGregor: person,Fight Island: location,
DMX: group,@YouTube: product
Chelsea: corporation,Thomas Tuchel: person,FA Cup final defeat: event,
Blue Abstract Design Macaw Feather: product,Fabric Face Mask Covering Adjust
TY: person,Taeyong: person,@NCT_127:
@user: person,@user: person,@user: person,Jeanne N
@Bernhard_Langer: person,Bryson: person,Tiger
Creativity Code: creative_genes, Chapter 13: creative_genes
Vance Joy: person,Australian Singer: person,FIRE: product,FLO
DONNY MAYMAY FATHERSDAYOnASAP: person,@Donny
@Surya_Kumar_Yadav: person,cap
@JHU_News-Letter: corporation,heart disease: group,p
@Chicago_Bears: group,Hard Knocks: event
YCMN: corporation,WWF: corporation,MV: product,WW
WDWFALLIN: creative_work,@Why_Don’t_We_
@Whit_Johnson: person,hired: person,@Whit_
@A'ja_Wilson: person,WNBA: corporation,Breonna
Sandip Ssingh: person,Sushant: person,Sushant:
Lord James FEDORA HAT: creative_work,Mandamental: person
@David_Mitchell: person,Alan Warner: person,Mor
Bob Dylan: person,Blunin' in the Wind: creative_work,@
30 minutes to kill in my car: creative_work,@BTS_twt
Task Bastard: creative_work,@user: person,@user: person
@user: person,hand to lips: event
@Scott_Hanson: person,@Scott_Hanson: person
Covid-19: event,@Full_Fact: corporation,Covid19
Saweetie: person,DaBaby: person,Jack
WORLD SERIES BOUND: event,world series: event,world series: event
Space: location,The Infinite Frontier: creative_work,Dr. Kent Wahl
Easter service: event,@The Grove: location
@Lewis_Hamilton: person,world championships: event,Gat
Badminton Group Training: event,JayPidz: person,P
Theatre hopes for the future. I ’ll start. @Andrew_Ll
@Hell's_Kitchen: corporation,season 4: event,Petro
Fernando: person,goat: person
Katy: location,@Southland_Conference: event,@Southland
Donald Trump Jr: person,@Yahoo: corporation
WWE: corporation,Wrestlemania Night Two: event,Nia Jax:
Future: creative_work,Victon: creative_work,TheFuture
Christmas came early for Dad & Joseph: person,@user snowmobile: product,M
@WazirX: product,India_Ka_Bitcoin_
@Thanasi_Kokkinakis: person,TV: location,
@The_New_York_Times: corporation,ED nurses: group,
Trump: person,Earthquakes: event,@President_Biden:
JusticeForDaphne: creative_work,@Manfred_Weber:
@ATEEZ: corporation
Porzingis: person,Carlisle: person,@Mark_Cuban:
BTDT Advisor: person,Essex Scholar: person,StudentAb
Valentine’s Day: event,@TOMORROW_X_TOGETHER:
Trump: person,White House: location,@user: person
COVID: product,blood clots: event
@Archive:_Governor_Andrew_Cuomo: person,
@Los_Angeles_Lakers: group,LakeShow:
@BTS_twt: group,@BTS_twt: group
Twilight Zone: creative_work,The Movie: creative_work,Alternative
@Squishmallows®: corporation,Squishmallows: product
99Songs Audio Launch: event,@A.R.Rahman_
Sue Bird: person,@Megan_Rapinoe: person,gold
815: event,@Paul_Bretl: person,Pike /
Ray: person,San Diego: location,@Voice_of_San
King Shark: person,Suicide Squad: creative_work,king shark: person
@user: person,@user: person,@user: person,@user: person
Happy New Years Eve: event,@Chuck_Hubert: person,@Aust
@jose_marie_viceral: person
@The_Church_of_Jesus_Christ_of_Latter
Prof Isa Ali Pantami: person,Prof Isa Ali Pantami: person
Patrick Wilson: person,Vera Farmiga: person,Ward: person,June
Nitrite-cured processed meats: group,World Health Organisation: corporation,@D
Tampa Bay Lightning: group,McDonald Canadiens: group,S
1YearOfPatiPatniAurWoh: person
The Marine and the Hippie: creative_work,14: creative_work,Sailing
@Emma_Blackery: person,Spotify: product
Wrestlemania: event,Wrestlemania: event,Wrestlemania:
Chelsea: group,Manchester City: group,Porto: location,@breakingnews.
Phil Collins: person,In the Air Tonight: event,@YouTube: corporation
Oxventure Blades in the Dark: creative_work,@Luke_West
Broward County (South Florida): location,NFL Hall of Fame: event,I
Fear the Walking Dead Season 6 Trailer: event,FearTWD: corporation,TWD
@Adam_Peaty_MBE: person,Gold: product,Toky
Dead Zone Detector: creative_work,@user: person,@user: person
@Listia: corporation,BBMBJS: product,The Power of I AM:
why can we now personalize the app icons yet we still ca n’t change the
@Joe_Biden: person,United States of America: location
TEXAS: location,Dan Crenshaw: person,@facebookwatch
BTS: creative_work,BSL: corporation,SSE: corporation
@Olivia_Rodrigo: person,UK Spotify: corporation
Teddy Bear BoomBox: creative_work,San Francisco Street Artist Zamiro T-
@Mitchell_Trubisky: person,@Chicago_Bears
Man Arrested After Allegedly Threatening To Assassinate Gov . De
Lampard: person,@Chelsea_FC: group
Satan: person,The Conjuring: creative_work,The Devil Made Me Do It
Fast bowling: event,@Waqar_Zaka: person,@C
Katie Halper: person,Meghan McCain: person,Katie Halper
vaccines: product,@LBC: corporation,@Tom_Swarbrick
@Donovan_Goliath: person,Mandeezy: person
MOA: corporation,WWFC: corporation,MAMAVOTE: group,@
@New_York_Mets: group,Hand: person,Da
Ohio State: corporation,@user: person
Manchester United: group,blues 2021: event,@user: person
Meghan: person,Harry: person,@Daily_Mail_Online: product
@METROFM_SABC: group,TheSacredSpace: group
Hamilton County Residents: group,@user letter: event,Mount Coppinger
BJP: group,WB: corporation,TMC: group,200 above states:
Aria: person,foals: group,clean up after lunch: event,@
@Shawn_Mendes Wonder: person,@Olivia_
SELFISH LOVE MUSIC VIDEO: event,@Selena
Chiefs: group,Bubb: group,KC: group,Breath: group
Rambo: person,Mortal Kombat 11 Ultimate Gameplay Trailer: creative_work
Half Time: event,@Northampton_Saints_: group,@B
Texas: location,Governor: person,Disaster declaration: event
Labor Day weekend: event,@News12NJ: product
@H-E-B: corporation,mask policy: product,mask use:
20’: event,@user: person,Loudon: person,MIAv
ONE MILLION STRONG: creative_work,PA VERSION: creative
@JARED_LETO: person,DenzelWashington: person,R
@South_Central_Railway: corporation,@Ministry_of_
Peter Griffin: person,Trump: person,Family Guy: group,Donal
Sea of Thieves: creative_work,@user: person,@user:
Broad St South: corporation,Broad St South: location,@user: person
JP 's Music Blog: creative_work,Independent Artist Robert Stoner:
Nigel Who: person,@Romain_Grosjean: person
TheOwlHouse: creative_work,Separate Tides: creative
@Niall_Horan: person,HeartbreakWeather: creative_
@Harry_Styles: person,music video: creative_work,falling
dynamite: group,life goes on100M: event
Carl Edwards Trophy: event,@ Birchwood GolfClub: corporation
@Russell_M._Nelson: person,Church of Jesus
Resurrection Sunday: event,Jesus: person,He is alive: person
J.Lo: person,A-Rod Split: event,@Hollywood
Whitney Houston: person,Super Bowl: event,Whitney Houston: person,@D
@MONTERO_: group,Sympathy For The Devil: event
@BBC_Radio_Leicester: corporation
@Ryan_Reynolds: person,pinky toe:
@user: person,jeopardy: event,7th: event,n
@user In The Building Of course: event,SmokeChamps: event
Charles Oliveira: person,Michael Chandler: person,UFC
Lightning: group,Tampa_Bay_Lightning: group,
@Philadelphia_Schools: corporation,@Philadelphia_Schools
Bay ward: location,262 customers: group,@Theresa_Ka
Phil Lesh & Friends: group,Phil Lesh: person,Phil Lesh:
Michigander: person,incel: person,white supremacist: person,bar
ThankYouDay: event,@user: person,ThankYouDay: event
Covid19: event,vaccine: product,ideas: group
BearMixer Live: event,New Years Eve 31st December 2020: event,
Ronald Reagan Interview: creative_work,The Tonight Show: creative_work,Johnny
The Devil Judge: creative_work,Bossam: person,Steal The
@Los_Angeles_Rams: person,cowboys
BIG MOUTH: group,@Big_Mouth: product
Olivier Kwizera: person,Blues: group,Gasog
COVID-19: event,Centers for Disease Control and Prevention: corporation,COVI
3 Major Reasons Why the CDC Changed Its Mask Guidelines for Vaccinated People
Sen. Ted Cruz: person,Maxine Waters: person,Daunte
Jerry Jones: person,Dak Prescott: person,Wheeboys:
Los Angeles Lakers: group,LA: location,NBA Finals: event,20
Epik High: group,MithraJin: person,Rosario
New Music: event,@Billy_Bragg: person,Columbian:
Trump Supporters: group,@Forbes: corporation
The Black Ice: creative_work,Harry Bosch Novel: creative_work,MyBook
India: location,@Financial_Times: product
Jansport: corporation,Sao Paulo: location,San Francisco: location,
Ethiopia: location,Africa: location,Africa: group,Africa: group,Africa: group
night insects: group,MISSIO: corporation,CanYouFeelTheS
Spartanburg: location,Morgan Square: location,Hub City: location,
Jerry Jeff Walker: person,@Pat_Green: person,Songs About Texas
Yoongi: person,@BTS_twt: product
Dynamite: group,TheSong: group,PCAs: group
Tampa Bay: location,@Tampa_Bay_Rays: group,
Dead Eyes: person,Jared Kushner: person,@Common_
@Phil_Gould: person,super league: group,international rugby: group,
Black Lives Matter: event,YouAintBlack: corporation,Rayla Campbell:
Manchester: location,@Liverpool_FC: group,@Manchester_Uni
Black Voices: group,Alicia Harmon: person
@YouTube: corporation,@Shania_Twain_:
Crossword time: event,Wlw: group,lesbian books: group,US
Trump: person,Omaha Rally: event,@Forbes: product
@user keychain: product,WA: location,air quality: product
@user: person,@user: person,@user: person,@user: person
@Ted_Lasso: person,@Ted_Las
@Robert_Whittaker: person,UFC254: event
@JrMasterChefAU: corporation,@MasterChef_Australia: corporation,MasterChef
@Reliance_Jio: corporation,@Reliance_Jio
Texas teacher: person,Black Lives Matter: event,@KMOV: product
@Mary_J._Blige: person,The Queen of the Goon
@UNCW_Basketball: corporation,Joe Pridgen: person,
Philadelphia 76ers: group,Los Angeles Lakers: group,107-106
@Ransom: person,Heavy Is the Head: creative_work,@
@Russell_M._Nelson: person
Dak Prescott: person,cowboys: person,@Dak_Pre
New Years Eve: event,@Andy_Cohen: person,@Anderson_
@PSAcard: corporation,@PSAcard: corporation
Wonder Woman Store: product,Warrior Princess Wonder Woman: person,Warrior Princess
GPT-3: corporation,@user: person,@user: person,GPT-3
Zombies map: creative_work,@user: person,@user: person,
Wonder Woman: person,750 Bosslogic Planet Awesome Variant: product
Porcelain Gold Rimmed Drinking Glasses: creative_work,@
Phenomenal season: event,@user: person,You guys: group,
Country Party: group,Auspol: group
Stephen King: person,Trump: person,Opinion: event
Coronavirus: product,@NHS Coronavirus test and trace: product,@NHS
Brady Heist: event,Tom Brady: person,Super Bowl LI Jersey: event,
Crisis DogBus: corporation,Dogbus: corporation,Dogbus: corporation,
@Scott_Hanson: person,@Red_Zone_Channe
Bittersweet: group,@(SEVENTEEN): group
BritishF4: group,Snetterton: person,Browning: person
@Novak_Djokovic: person,match: event
Winter Storm Warning: event,Wintry mix: product,Wintry mix: event,N
SEVENTEEN: group,@(SEVENTEEN): group
@Teofimo_Lopez: person,fair fair and square:
BaTorrent: creative_work,LatokenApp: creative_work,@ANO
Steelers: group,RavensFlock: group
Stanley Cup Final: event,Salain Cup Final: event,Champs:
Candlestick Park: location,SFGiants: product,@Etsy:
New Years Eve Party: event,YANA: person,You Are Not Alone: person
@TRAVIS_SCOTT: person,Lit: person
Pfizer: corporation,FDA: corporation,Kids: group,@
@Air_Canada: corporation,flight: product,refund: product
TSA: corporation,@BTS_twt: product
DMDUSandcastles: event,AustralianWrestling: event
Richmond: location,Black Lives Matter: event,@user: person
Biden: person,Trump: person,Pennsylvania:
AEW: corporation,TV Show: event
@Foundation_: corporation
RoyalCaribbean: corporation,@Royal_Caribbe
@Jill_Biden: person,@Jill_Biden: person
You Cannot Kill David Arquette: person,New Years Eve: event,@Da
WrestleMania 37 Night One Results and Analysis: event,@user: person
Ted Cruz: person,Hidi: person,Cancun: location,@
@Las_Vegas_Raiders: group,Derek Carr:
The Black Keys: group,delta Kream: group,Zip File:
ASAPFeelGood: corporation
San Francisco mayor: person,Burning Man: event,Americans across the country
Australians: group,June: event,@The_WOMBATS: group
Covid: event,Pennsylvania: location,Penn
Dalit: group,CatholicChurch: group,India: location,TN:
Secret Service: corporation,Hunter Biden: person,@POLITICO: corporation
lilyan: person,milk: product,wesgreen: person,pop:
Julio Jones: person,Titans: group,Vikings: group
Mcgregor: person,Dallas Cowboys: group,AT&T
COVID 19: event,rich countries: group,poor ones: group,@
San Francisco: location,@Business_Insider_: product
@Transport_for_London_: corporation,@Mayor_of_London
Lucy Hodson: person,@BBC_Radio_3: corporation,Blackbird
NitroEx: corporation,NitrexForMyFuture: product,BTC
@Hillary_Clinton: person,Pundits: group,L
Halloween special: event,Scotland: location,Syd Moore: person,
Maddie: person,@user: person,Maddie: person,@user
Imeenda Rome: location,Italy: location,Euro2020: event
Magic happens when you use the power of your heart and mind to create reality. Miracles happen
Stan: group,@Lady_Gaga: person,@Taylor
BringTheBoxToIndia: event,CHANYEOL: product
Balaji layout byadarahalli: location,power outage: event,power
@Cleveland_Browns: person
@Aya_Nakamura: person
@Eduqas: corporation,Jupiter: person,Io:
The Power to See What Does Not Exist and Make it Happen: creative_work,BIZ
John Longmire: person,Port Adelaide: location,Assembly Oval
Blue Weekend: event,Play The Greatest Hits: creative_work,@Wo
Kevin Durant: person,USA: group,Olympics: event,Gold
Dom: person,therapy: creative_work,blood: color,@YUNGBLUD
@user: person,Travel In Time: creative_work,WATCH NOW:
BillsMafia: person,Bills: group,Buffal
@Atlanta_Police_Department: corporation,Pryor Street
@user: person,swan song: creative_work,Leslie Nope levels
@Oklahoma_Football: corporation
teumes: group,MAMAVOTE: group,treasure
Louisville: location,Kentucky Derby: event
@IDK: corporation,Rolling Loud: location,@IDK: group
Sarcastic Funny Gift Yet Despite the Look on my Face Mug Gift by Crafty
UK charity: corporation,Netflix: corporation,FilmClub: corporation,
@Gary_Ellerson: person,@leroy_butler: person,
Cripps: person,Blues: group,Aretha Franklin: person,
LAYLALAY: creative_work,@YouTube: product,J97
@THE_VOICE: product
Thailand: location,The Sound Of Silence: creative_work
@A_View_from_the_Terrace: corporation,open goal: creative
@Kerala_Police: corporation,@CPI_(M):
New Year’s Resolutions for the Planet: event,@The_New_Yor
grocery shopping: event,gallon-sized water bottle: product,labor day weekend:
Never Digitalized: creative_work,@iTunes: corporation,@Ama
NowruzMubarak: person,Iran: location,Kurdish
Chiefs quarterback: person,Super Bowl MVP: person,@HuffPost_Ent:
Mclaughlin Group: corporation,@Patrick_J._Buchanan
@iHeartRadio_Canada: corporation,WatermelonSuger: creative_
VotersAssemble: event,@Kamala_Harris
Texas: location,Hurricane Delta: event,@ABC_News
Pitt Panther: person,Mark Henderson: person,@user ambassadors: group
@Battlestate_Games: corporation
Ricky DIllard: person,@YouTube: product,HappyFa
Bryan Thompson: person,@Utah_Football: group,
CRAVITY: group,anniv: event,we are still behind on the funds
Burning Hot Babes: event,Disha Patani,Nora Fat
@Atlanta_Braves: group,Dodgers: group,
NSW woman: person,@Illawarra_Mercury: corporation,@J
AppointTeachersOn1stJulyInMP: event,
@Bianca_Belair: person,@Mercedes_Var
Porzingis: person,Doni: person,@Mark_Cuban:
Lawsuit: event,Trump: person,Ballot counting facility: location,P
Beautiful: creative_work,Debate2020: event
"You have to learn to distinguish the voice of God and the voice of your frustration ,
Anthony Fauci: person,Americans: group,Labor Day weekend: event,American
Wimbeldon FC: corporation,@Warren_Barton: person
Lewis vs. Gane: person,MMA Junkie Radio: corporation,@MMA
British: corporation,@Sunday_National: corporation
@user: person,@user: person
@user: person,@user: person,@user: person,@user: person
@Houston_Astros: group,@Los_Angeles
OptixEQ Race of the Day Analysis: event,@Santa_An
crypto imposters: group,@Twitter: corporation,@Twitter_
Drew Brees: person
POTUS: person,Biden: person,BidenHarris:
United States: location,Brazil: location,gold medal women ’s volleyball:
UGH: group,power: group,00:00: event,@BTS_t
Demi Lovato: person,Sam_Fischer: person,The Sun:
Welcome To The Playoffs Champ: creative_work,@DistroKid
Packers: group,@Green_Bay_Press-Gazette: product
Norwegian Royal Family: group,Norway: location,Olso: person,
@(G)I-DLE()
JJ: person,@AJ_Cook: person,Fate: group,C
Adam Toledo: person,@user: person,@user: person
christmas came early: event,@user: person,Senicokseviy
Trump: person,Journal: event,Arizona: location,@
WrestleMania37: event,@Bobby_Lashley:
World Read Aloud Day: event,February 3: event
Red Sox: group,Dave Roberts: person,Dodgers:
East Belfast GAA club: corporation,Catholics: group,Protestants: group
The Human Centipede: creative_work,2009: event,Movie Review
JosephCampbell: person
Drishyam 2: creative_work,@Mohanlal: person,
@Rocket_League_Esports: corporation,Admin position: product
Chelsea: group,Leicester: group,FA Cup final Conclusions: event,@
Cowboys: group,Gameday shows: event,Washington game: event,
Martin O Kilmer: person,Dance Mix 2021: event,@YouTu
Clyde: person,surfer: person,SPSshow: product
@Bill_Gates: person,Oxford: location,AZ: location,
Bundesliga: event,Sky Sports App: product
Watergate: event,US navy: corporation,@alimohsnala
@UFC: corporation,@Samuel_Adams_Beer
New Years Eve: event,2021: event,Raven Tacwigan:
@Timbaland: person,Rolling Loud: location,Crazo:
Chelsea: group,Man City: group,Chelsea_FC: group,Ch
Podcast: product,Are You Getting Stuck in the Conversation Red Zone: creative_
Serotonin: person,@Sara_Bareilles: person,Hollywood
Permission to dance: creative_work,MV: creative_work,@BTS_
Southgate: person,England: location,Italian anthem:
Monarch Fedora: person,Honey Green: location,KIRK: person
World Series: event,@SFGiants: group,@Budweiser:
Ohio State: group,Iowa: group,NY6 bowl game: event,H
Lil Wayne: person,Scottie: person,@YouTube:
@RodWave: person,Miami: location,Rolling loud
Army: group,Army: group,Army: group,Army: group,
Chelsea FC: group,Gueriola: person,Man City: group,@Prem
Oregon: location,@grist: product
@The_Lincoln_Project: corporation,Trump: person,Du
Trump: person,@YouTube: corporation,Trump: person,Fa
@Louisville_Baseball: corporation,Henry Davis: person,Pi
EXO: group,@YouTube: corporation,EXO-L
@Scarlets_Rugby: corporation,Tom Rogers: person,PRO
Labor Day weekend: event,Minneapolis: location,@Pioneer_
@BLACKPINKOFFICIAL: person,ALBUM: creative_work,
@Olamidé: person,@nairamarley: person,@W
Steiff: company,Teddy bear: creative_work,Soft Cuddly
@user: person
Holy Church of Grabba Sunday Sermon: event,@Clubhouse: location
New Year’s Eve: event,@Target: product, toilet paper: product
Fate: creative_work,@YouTube: corporation
Thug Love: creative_work,RnBMusic: creative_work,Ladies
donald trump: person,@Joe_Biden: person
@Minerva_Academy_Football_&_Crick
Meléndez: person,Ortiz family: group,Remain in Mexico
ARASHI: person,Person: group,SHO TIME: product,The
40 point triple double: event,conference finals: event,@Book: product
Leaders: group,@Marker_by_Medium: person
Donald Trump Melania: person,DJT: corporation,The Greatest Of All Time
Cloud: location,Data Integration: event,Data Integration: event,Data Integration: event,
Trump: person,New Years Eve: event,Vanilla Ice: person
The Walking Dead Season 10 Episode 18 Full Scene: event,TheWalkingDead:
Trump Tower: location,Black Lives Matter mural: event,@New_York
@BTS_twt: product,BTS: group,PermissiontoD
Labor Day weekend: event,@user: person,Bella Bianca Dinnerware:
Kershaw: person,Buehler: person,Dodgers: group
Jill Biden: person,White House: location,Green Jewel-Toned Jacket
GhostNation: group,@Jason_Hawes: person,@
Vintage Italian Beautiful Woman: creative_work,Long Hair: creative_work,It
@Chicago_Bears: group,super bowl: event
Luke Shaw: person,Red Devils: group,Defenders: group,@
Zinger: person,@Xander_Schauffele: person,Phoen
Georgia State Bar: corporation,@The_Epoch_Times: corporation
@7-ELEVEn: corporation,Xbox Series X: product
President: person,President: person,@Bop_Daddy: person
@Taylor_Hall: person,NHL: corporation
GrimReaperOfTheSenate: corporation,MoscowMitch
@NeNe_Leakes: person,DecemberBabies: group
Supernatural Benefits oftheNewCovenant Blood of Jesus Christ: creative_work,@
Ethiopia: location,Tigray: location,TigrayGenocide
OCEAN EYES: creative_work,@mewsuppasit:
RespectLay: person,@Lay_Zhang: person
Christmas Special: event,@Raymond_Arroyo: person,Christmas Special
FBI: corporation,Trump Supporters: group,Biden Bus: event,T
US: location,@National_Guard: person,US: location,govs:
Nigerian: person,@Babajide_Sanwo-Olu
EXMR: corporation,New Years Eve: event,Huge News: event,Hu
NBA 2K21: event,@TheAnnex: location
People have the right to film the police, and efforts by the police to infringe
freeze focused playlist: creative_work,@TOMORROW_X_TOGETHER
@997NOW: corporation,Wander: creative_work,Shawn Men
Trump Interior Hire: person,White Supremacist: person,Black Lives Matter:
Pubs: group,clubs: group,music venues: group,library: group
Oklahoma: location,Oklahoma: location,Five Tribes: group
nightshotpromo: event,Jim Jones: person,Lil Wayne: person
@Match_of_the_Day: group,@Match_of_the
therapists: group,@user: person
@NBA: corporation,league: group,@LeBron_James:
baekhyun: person,@Baekhyun_E
JusticeForAdarshMembers: group,@PMO_India: corporation
Permission to Dance: creative_work,Spotify: corporation,Daily:
Red Velvet: person,@YouTube: corporation,@MAMA:
Manchester City: group,Community Shield Date Set: event,@user Dates
BTSxUNO: corporation,@UNO!_Mobile: corporation,@BT
UFC 265 results: event,Torres: person,Hill: person
@Josh_Mandel: person,park: location,dog: person
Weekend: event,@user: person,@B2B: event,@Bur
Ride With Me: event,Mental Health Awareness Charity Cycle Ride Experience: event,@
@Meghan_McCain: person,@Meghan_M
Bad Girls Club: group,@user: person
@Timothée_Chalamet: person,super bowl: event
Congress Government in Chhatisgarh: location,@Bhupesh_
@Medium: corporation,The Greatest Sales Page: creative_work,I ’
Iowa State: group,BCS: group,@College_Football
Community Update: event,Marc 12: event,State Champs: event,D
Nevada Trump supporters pray for election victory: event,@Yahoo: product
CNN: corporation,Don Lemon: person,Trump Supporters: group,Addict
NowPlaying: event,Lil Wayne: person,Rick Ross: person
ABC: corporation,GreatBarrierReef: corporation,ReefLiveAU:
Clubhouse: corporation,@Dispo: corporation
Super Bowl: event,@Bruce_Springsteen: person
RIPdrake: person,fart: person
Middle of the Road: creative_work,Level 78: creative_work
Grown up clothes are so overrated: event,@Lacey_Chabert
Liverpool: group,Lille: group,Sven Botman: person,LFC
Dustin Johnson: person,Masters: event,@Jim_Souhan:
Hurricane Threat Nears for Gulf Coast: location,Tropical Storm Sally: event
@SZA: person,Shirt: creative_work,New Favorite Song: creative
Martial: person,Puma: product,@Nike: person
Environmental Inequalities, Policing Protest & Political Denial: event,
ayyy may epal: creative_work,AHHAHAH MO
@Dak_Prescott: person,Mom: person,brother
@user: person,milk white neck: person,Devil: person
@bigbasket: product,chicken liver: product,chicken liver: product,
Fight The Power: creative_work,2020-Rewind: creative_work,@
@Zane_Lowe: person,New Music Daily: event,WKM
Urban Meyer: person,Michigan: location,@Michigan_Foo
Labor Day weekend travelers heading to COVID-19 hot spots: event,@NBC_New
Nigerians: group,Bayer: group,Chelsea: group,
@Google_for_Startups: corporation,Founders Academy: event,@
German Pilot Draws Giant Syringe in the Sky: creative_work,@L
Glenn Frey: person,The Heat Is On Video HD HQ Remastered:
Denzel: person,@HBO_Max: corporation,Rami Malek:
Happiness: event,@ColorsTV: corporation,@Voot:
Titans: group,@Jaden: person,@user: person
Ras Midas: person,Reggae Chalet: location
Koryn Hawthorne: person,@user: person
PullTheTRIGGERWithVRVR: creative_work,@VERIVERY_OFF
Raheem Sterling: person,ManCity: corporation,Harry Kane:
@Aljamain_Sterling: person,belt: product
The Dark Side: creative_work,Level 2: creative_work
Trump: person,Governors: group,Labor Day Weekend: event,@The
Eagles coach Doug Pederson: person,Jalen Hurts: person,
Kunfu pandya: person,@hardik_pandya:
SomeoneSavedMyLifeTonight: event,@Elton_John: person,Rock
Kamala: person,TX: location,Trump: person,Left
Ice Guys: corporation,Honorable mention: person,Honorable mention:
Club House: corporation,@user: person,EverydayEthiopia: corporation
Mat B: person,WrestleRome21: event,@Brandon_
Manchester United: group,@Arsenal: group,UK: location,K
Jokhon porbena: person,Endavouring Tagore: creative_
VanjossExclusive: product,CupidSanta:
Trump: person,Republicans: group,@Julian_Zelizer
phasmophobia: creative_work,@user: person,Distracted
Houston: location,@user: person
@user: person,@user: person,@user: person,@user: person
@Killian_Woods: person,@Donal_MacNamee
Elephant Hexagon: creative_work,Australianmusic: product
NOW LIVE: event,Match Singles: event,£ 10 to £ 100
@user: person,St. Albert: location,@user: person,Wrest
20th anniversary: event,@Sum_41: person,All Killer: person
Apostles: person,Holy Spirit: person,BuildingBetterRelationships
Dragonfly Fabric Face Mask: creative_work,Adult Pleated Handmade
Labor Day: event,American Worker: person,American Worker: person,American Work
@Dan_Rosen: person,Stanley Cup Final: event
10 Side Hustle Skills You Can Master During This Labor Day Weekend via @Entre
@Olivia_Rodrigo: person,driver license: product
Rita: person,@Geoff_Gustafson: person,POs
@Cori_Bush: person,her constituents: group,HER: person
@Tom_Ballard_: person,@Dan_Ilic_
Law school: event,@user: person
Give Online: corporation,@WordPress.com: corporation
Dorset: location,Dorchester: location,Dorchester: location
Max Gawn: person,@inkl: product
Turning Up: event,@ARASHI: person,@MTV: corporation,
Poshmark: corporation,The Look Randolph Duke Dress Plus Size 1X: product
California: location,Trump supporters: group,@Conservative_News: product
Pandey: person,TanushreePandey: person
@Liz_Claman: person,CDC: corporation,masks after
MI5: corporation,Russia: location,China: location,Iran: location,right
@HuffPost_Politics: corporation,@HuffPost_Politics
Sponsored: event,@Telegraph_Business: corporation
Bears: group,@user: person,Bears: group,@user:
Smoked brisket, sliced up and ready for Labor Day weekend !
@WA_Police_Force: group,@DFES: corporation,@S
Penn State: corporation,Ohio State: location,@DraftKings_
New Years Eve: event,Paris: location,@user: person,@user:
@Andy_Day: person,Clever person: person
Truth and Grace Homeschool Academy: corporation,Ghosted at the Altar: location
@mewsuppasit: product
Clemson: group,Ohio State: group,Sugar Bowl:
Russell: person,Messa: corporation,@Mercedes-AMG
Raksha Bandhan: person,@Allu_Arjun: person,
snl: corporation,kristen wiig: person,@Saturday
@BritBox_UK: corporation,Stanford T Davies: person,
LEGO bricks: product,Star Wars: event,LEGO: corporation,LEGO:
Trump: person,Trump: person,@Yahoo: product
Covid: disease,U.S.: location,@The_New_Yor
@Prince_William_County: corporation,cooling centers: location
San Francisco Mayor Breed: person,Nancy Antoinette Pelosi: person
Wrestlemania: event,@WWE: corporation,WrestleMania:
Block the Road: creative_work,Fay-Ann Lyons: person,C
Snowy Breck: person,Colorado: location,Cookx: person,
footballers or ex-footballers: group,@Gary_Neville:
@Mick_Schumacher: person,@Haas_F1_
DOJ: corporation
@euphoria: creative_work,@Hunter_Schafer:
@Howard_WGR: person,Bills: group,@WGR_
Johnson & Johnson COVID vaccine: product,@Daily_Mail_Online
XIUMIN: creative_work,MR QUEEN: person,XIUMIN
Covid-19: event,Middle East: location,@Brian_Whit
Maldivian Rufiya: person,@MMA: corporation
Sam: person,@SB19_Official_: person
@Amazon: corporation,@user: person,@PaydLink: product
@Reba: person,@REBEL_not_reba: person
@Runtown: corporation
CecilyStrong: person,Super Bowl musical: event,@Saturday_N
Hip-Hop Boombox Teddy Bear T-Shirt Urban Picasso Art URL via
Haotong: person,PGA Championship: event,@user: person,@user
Shinee: person,BistrodeSHINee: person,@SH
The Story of Love: creative_work,Greece of God: creative_work
@The_Week_with_Joshua_Johnson: person,@
Middle of the Road (Level 86): creative_work,@user: person
the view from up here: creative_work,@user: person
SegundaDivisión: group,Apertura R1PO: group,
@Joe_Biden: person,@Kamala_Harri
@Maurice_Hooker: person,@Maurice_Hooker: person
TropicalStormHenri: event,@National_Hurrican
France: location,Thomas SIMOES: person,Sshuchita:
Parker Messick: person,@FSU_Baseball: group
Love In The Air: creative_work,@_GFRIEND: person
@Sophy_Ridge: person,Starmer: person,Grey
@United_Nations: corporation,@Human_Rights_Watch
Angel Hernandez: person,New York replay booth: location
Sundowner: creative_work,@user: person,Sundowner: product
@New_Orleans_Saints: group,@New_Orleans_
DeFi: corporation,@Solana blockchain: product,@user: person,@
@Walmart: corporation,JobOrTheJab: product
@ocado: person,delivery: event,house: location,12:
Free information: creative_work,@The_Register: corporation
Nick Foles: person,hospital balls: event,@ESPN_1000: product
@Blaire_White: person
Cam Anthony: person,Cynthia Erivo: person,Stand
@Deontay_Wilder: person,Northport: location,
NowPlaying: event,The Voice Perfor: creative_work,@Jio
@Mariah_Carey: person,Underneath: location
California: location,@kurtis_conner: person,Joker: person
UFCVegas32: event,@Michael_Chiesa
@user: person,@user: person
@user: person,SKZ: corporation,Ken Levanter gais: person
JOKER: corporation,Dark Knight: creative_work,BANK ROBBER
LineofDutyFinale: event,Muppet: person,@Line
World Class pianist: person,Carol of the Bells: creative_work,@
@NYC_Public_Schools: corporation,COVID19: event,NY
Morikawa: person,Masters pool: event,Open Championship: event
Sunday: event,@Dr.GURMEET_RAM_RAHIM: person,
Kansas City Chiefs: group,Patrick Mahomes: person,Tom Brady:
NFT: creative_work,NFTart: creative_work,Audius_
VB: event,MSU: group,game 1: event,MSU: group
Terimakasih team: group,@Chelsea_FC: group
Sunday special: event,@user EP: corporation,RWMOH: corporation
@BTS_twt: product
God: person,Word of God: person
@NVIDIA: corporation,@NVIDIA_GeForce: corporation
Kentucky Derby: event,Declarn: person,Cat Derby: event,@Big_
GH: group,@ABC: corporation,@Frank_Valentin
Fat Joe: person,DJ Khaled: person,Amorphous: person,S
@New_Orleans_Pelicans: group
TWICE: corporation,Whosfan: person,Anniversary 1: event
Christmas: event,@user: person,Gigi: person
JAM Kick Off Final Liga Champions Man City Vs Chelsea, Ada 2 Momen The
@user: person,gameplay battlefield 2042: event
@Ron_DeSantis: person,masks: product,@R
Dublin City: location,James Joyce: person,House of the Dead: creative
@L.A._GUNS: group,Checkered Past: creative_work,
@The_Telegraph: corporation,weddings: event,Victorious
DJ Cheyanne Blues'n up your: person,Chained To
Japan women: group,Tokyo2020: event,China: group,Hockey
Tsitsipas: person,Rafa: person,Barcelona
Nick Foles: person,Mitch Trubisky: person,Bears controversy:
ARCHIMEDES BANYA: creative_work,San Francisco: location,@
Kentucky Derby day winner: person,Delf Mar finale: event,Richard Mandella
Pixies: group,Monkey Gone To Heaven: creative_work,@You
Trump supporters: group,Oakland airfield: location,@NBC_News
Rosamund: person,@user: person,@user: person
@Scott_Morrison: person,UK: location,UK: location,UK
New Years Eve: event,ILU: corporation
Hovec Sawmill: creative_work,Hivec Sawmill: creative_work
@Ellen_Johnson_Sirleaf_Presidential
President Joe: person,USA: corporation,@Bloomberg: corporation
FBI: corporation,Trump supporters: group,@Google_News: product
DestinedSidNaaz: person
Don Life: creative_work,Big Sean: person,Lil Wayne: person,@
Long way .. . Hard work .. . Amazing performance ..
LFS: group,@user: person,@user: person,@user: person
Drivers License: creative_work,@Olivia_Rodrigo
@user: person
Lil Baby: person,Lil Durk: person
Pence: person,Harris: person,Utah: location,Tru
@HYBE_OFFICIAL: group,@BIGHIT_MUSIC: group
@user: person,UX Researcher & Designer: person,San Francisco:
Strong storm system expected to impact the area New Years Eve . Heavy rainfall and severe weather could
@Anthony_Ramos: person
@KE: person,Karachi: location,Karabakh: location
Israel / Palestine: location,@ITV_News: corporation,Israel: group
NowPlaying Lushy Banton: person,Black Lives Matter: event,C
Cirelli: person,Lightning: person,Stanley Cup Final:
Envy: event,@Taiwo_Odukoya
Car washes: group,UK: location,@Financial_Times
Trump: person,Arizona: location,Pennsylvania
Southampton youngsters Alex Jankewitz & Dan N’Lundulu: person,Saint
AliJavanmardi: person,Iran: location,@Twitter_S
Anonymous: person,@PayPal: corporation,Back2school shopping: product
Cristiano Ronaldo: person,Paul Pogba: person,Gabriel
Anitta: person,GirlFromRio: product
@Big_Ten_Conference: corporation,@Big_12_Conference:
Put Power Book II Ghost: creative_work,@Netflix_Is_A
@Wythenshawe_Amateurs: group,@Wythenshaw
@Olivia_Rodrigo: person,27: person,s
Man City: corporation,Pep Guardiola: person,Chelsea: corporation
Trump: person,@AOL.com: corporation,FAIR AND SQUARE:
Boryeong: person,South Korea: location,@Change_org_
@Arnold: person,@Arnold: person
Best Group: creative_work,Best collaboration: creative_work,PCA: corporation,
Jets: group,@Buffalo_Bills: group
Tampa Bay Lightning: group,Dallas Stars: group,2020 Stanley Cup Final
@Ariana_Grande: person,@Pinterest: corporation
12 Am: person,Senate: group,House of Representatives: group,
Pass the Fake News Bill: creative_work,@Ahmad_Ibrahim
ICYMI: corporation,Elyria grad: person,Ohio
TriNaM: corporation,@user: person,TronaM: corporation
@NBA: corporation,Lakers: group,WWCC: event,Lebron
Houston_Astros: group,Houston_Astros: group,A
Mark Scheifele: person,Jets: group,Canucks: group,
@user: person,TARKOV: product
Attack on Titan: creative_work,@Mike_McFarland_
Body Cam Footage: event,Tucson Police Officer: person,shooting
LISA: person,KING CHOICE: corporation,GAP: product,LISA
Gravity Software: product,@user: person,GrowYourBusiness: corporation,Ent
Lowry Hotel: location,club: group,James Cooper: person
@user: person,Gophers: group
@Cara_Dillon: person,blues: creative_work,No-
Turkey: location,Azerbaijan: location,Artistsakh: group,T
@user Members: group,@user: person,@user: person,@user:
Peter Dutton: person,Biloela: location,@Change.org
ENGENES: group,ENHYPEN: group,ENHYPEN: group,EN
UFCFightIsland: corporation,UFC253: event
@user: person,Romney: person,Republican: group,S
Chelsea: group,FA Cup final: event,Leicester: location,Wemble
Apple Music: product,City Chart: location,CDMX: group,Permission
@Dan_Marino: person,@Miami_Dolphins
@user: person,Kim Younghoon: person,@user: person,
Native American Turquoise Rings: creative_work,Great Fi: product,@
@user WE LOVE YOU SOHEL: product,HBDIsmartSohe
F1: event,@David_Croft: person,@Martin
Hurricane Ida: event,New Orleans: location,Baton Rouge: location,
Gary: person,The Suicide Squad: creative_work,2021: event,@
100milanjoscomerick: person,RavensFlock: group
POWER BOOK 2: product,@YouTube: product,PowerGhost
Twitter: corporation,Trump: person,TheHill: location,@Google_New
NotreDame: group,Clemson: group,Ohio State: group
Richard: person,@user: person,@user: person
Derbyshire Dales MP Sarah Dines: person,English Tourism week: event,@
@Bronwyn_Robbins: person
blashill: person,stick battles: event,NSH: group,th
NYE: event,@Mixcloud: corporation,@Twitch: corporation,
Mac: person,Queen: person,Harry and Meghan: person,@D
sacredground: group,ODP Ohio South: group,Columbus Crew: group,
@Olivia_Rodrigo: person,song drivers license:
Christmas: event,@Sanford_Health: location,ND: location,COVI
Monroe County: corporation,COVID vaccine equity: product,@Democrat_&_Ch
George Vanderheiden: person,StockMarket: corporation,sunday
AI: product,@Harvard_Business_Review: product
VakeelSaab: creative_work,Roju Gurthoch
@HLN: corporation,Mike Pence: person,Russians: group,
SmallanyanaAccounts: product,@user: person,@user: person
Bill Gates: person,@The_Western_Journal: corporation
FreeDawisu: person,@Peacock: person,@M
Photographer: person,Tui: person,@nzherald: product
Tampa Bay Lightning: corporation,Santa Clara Cup final: event,@Lea
Attack on Titan Season 4: event,@Crunchyroll: person,@Fun
season: event,@Philadelphia_76ers: group
@Too_$hort: person,Salinas: location
National Sisters Day: event,@user: person
Barasirohi kalyanpur: location
@Governor_Kate_Brown: person,@CBS_News
WakeUpwith10: event,@NEWS10_ABC: corporation
Trump: person,@VICE: product
No. 3: person,Big East: location
Coronavirus: creative_work,UK: location,OlderPeople: group,L
Emiway Bantai: person,@Emiwaytweet
Labor Day Weekend: event,Rooftop: location,Labor Day Weekend: event,
@user: person,Drag name: creative_work,Sonic The’Hedge
@Narendra_Modi: person,@ModiHaiToMum
Biden: person,Detroit: location,Bodden: person,2020
A / Way together: event,vaccinas: product
Trevor Noah: person,Trump: person,@Yahoo: product
Bob Altemeyer: person,@user: person
Turning Up: event,@ARASHI: person,@MTV: corporation,
Lightning Round: event,Dallas Stars: group,Stanley Cup
Jane Eyre: person,Charlotte Bronte: person,@Khaled
Outro: person,cross the line: creative_work,BorderDayOne:
TaylorSwift: person,@Taylor_Swift:
Edo State: location,@Official_PDP_Nigeria:
@Jimmy’s_Famous_Seafood Squad: group,
@Listia: corporation,BBCYGG: corporation
marathon: event,@DeRAY_DAVIS: person,HoOD_HERO
Suicide Squad 2021: event,@John_Cena: person,Pe
Manchester United: group,MUFC: group
@Jared_Padalecki: person,TV: product
Tropical Storm Sally: person,Los Angeles: location,@NOLA.com
Ohio State Cardio-Oncology Center of Excellence: event,@The_Ohio
@Hugh_Laurie: person,NHL hockey: group,Bol
Bryson DeChambeau: person,Masters: event,@Martin_
@Cleveland_Browns: person,game: event,depleted
Sour Beach: location,Saturday 28th of March: event,@user:
@Denver_Broncos: group,Charles: person,San
Chemistry: product,black and white: color,science print: product,facemask:
@Israel_Adesanya: person,@Paulo_Costa_(_
@PRO: corporation,@user: person
Flag Days: event,The Red,the Black & the Green: creative_work,
SpiritualSunday: event,@Dr.GURMEET_RAM_RAHIM
Ottawa 33 - SC 31 | 19:28 2H: event
@Jimmy_Butler: person,@Miami_HEAT: group
Super Bowl: event,@Cleveland_Cavaliers: group,Dog
Public Enemy: group,Do n't Believe The Hype: creative_
Numbers: group,Psalm 35: group,Ecclesiaste
God Save the Queen: creative_work,Level 7: creative_work
Blaney: person,Hamlin: person,Bowman: person,@
Country Music: creative_work,Australia: location,@user: person,Wante
Victims Of The Beats: creative_work,Spotify: corporation,@
Russia Putin: person,Russia: group,Russia: group,Russia: group,Russia:
Mythpat: person,OP Gaming: corporation,@Slayy_Point: person
Bitcoin: product,@Bloomberg_Technology: product
@Israel_Adesanya: person,UFC259: event
@Cyberpunk_2077: person
Breezy: person,second half: event
Full Body Burden: creative_work,Growing Up in the Nuclear Shadow of Rocky
Poshmark: corporation,SUN 12 / 27: event,EVE SOON
Blake Coleman: person,@Tampa_Bay_Lightning:
Kavin: person,Kavin: person,Kavin: person,@K
Marsabit County's security situation
Seminole County: location,vaccine: product,Seminole County
The Voice search Daily: creative_work,@user: person,ai: person
@Teofimo_Lopez: person
@user: person,fence: creative_work,dog: creative_work
mountaintop cable car: event,Italy: location,@The_Associated_
Tjo: person,Osebeditse: person,Blessings:
WatermelonSugar: creative_work,@Harry_Styles: person